DBN,name,year,total_enrollment,female_num,male_num,asian_num,black_num,white_num,hispanic_num
25Q169,p.s. 169 bay terrace,2014,396,178,218,120,14,179,74
02M529,jacqueline kennedy onassis high school,2010,707,441,266,39,172,21,473
15K464,secondary school for research,2008,499,261,238,37,189,32,223
10X091,p.s. 091 bronx,2015,742,350,392,26,145,15,544
22K405,midwood high school,2009,3758,2053,1705,1099,1427,841,385
31R065,p.s. 65 the academy of innovative learning,2018,430,213,217,9,78,106,204
09X263,validus preparatory academy: an expeditionary le,2009,426,298,128,1,156,1,266
20K505,franklin delano roosevelt high school,2008,3608,1590,2018,1270,340,664,1326
14K126,jhs 126 john ericsson,2008,610,289,321,14,112,65,419
32K564,bushwick community high school,2011,420,211,209,1,166,8,242
02M408,professional performing arts high school,2006,420,305,115,16,102,193,75
13K605,george westinghouse career and technical education,2018,756,192,564,34,534,16,154
23K155,p.s./ i.s. 155 nicholas herkimer,2017,454,218,236,12,229,6,200
13K527,urban assembly institute of math and science for,2010,317,317,0,9,265,4,36
03M421,west prep academy,2011,123,60,63,2,70,5,43
29Q268,p.s. 268,2008,505,255,250,97,301,15,85
75X012,p.s. x012 lewis and clark school,2017,291,77,214,9,93,13,156
02M439,manhattan village academy,2014,414,277,137,26,51,27,301
10X032,p.s. 032 belmont,2014,805,417,388,5,198,14,579
29Q195,p.s. 195 william haberle,2017,579,296,283,6,531,5,30
24Q102,ps 102 bayview,2006,814,402,412,482,17,56,258
32K554,all city leadership secondary school,2017,413,233,180,25,42,29,315
10X268,kingsbridge international high school,2007,223,110,113,14,16,6,185
14K582,m.s. 582,2014,272,117,155,0,73,4,191
25Q460,flushing high school,2006,2661,1242,1419,614,550,140,1302
10X045,jhs 045 thomas c. giordano,2006,1341,657,684,24,198,82,1031
75M721,p.s. m721 - manhattan occupational training center,2017,170,57,113,19,48,9,94
15K443,new voices s. of acad. & creat,2007,418,259,159,27,81,86,222
23K271,is 271 john m coleman,2006,464,207,257,1,389,5,65
09X215,kappa,2014,335,207,128,24,166,3,140
21K303,is 303 herbert s. eisenberg                     ,2012,641,335,306,129,87,213,209
11X087,p.s. 087 bronx,2017,601,270,331,35,431,6,94
29Q038,ps 038 rosedale,2008,348,176,172,9,313,7,18
15K447,the upper carroll school,2011,502,236,266,53,139,181,120
30Q092,ps 092 harry t stewart sr.,2011,886,450,436,8,28,4,846
15K010,magnet sch. of math sci and design tech,2008,575,278,297,33,95,133,314
30Q126,albert shanker school for visual and performing,2006,815,392,423,177,156,56,422
75K373,p.s. 373 - brooklyn transition center,2014,353,120,233,7,216,17,108
18K114,ps 114 ryder elementary,2007,922,472,450,14,793,26,78
22K206,p.s. 206 joseph f lamb,2014,1393,685,708,659,35,559,131
01M034,ps 034 franklin d roosevelt,2011,393,194,199,27,81,10,270
21K177,ps 177 the marlboro,2008,891,430,461,295,14,342,240
10X046,ps 046 edgar allan poe,2008,1220,595,625,33,210,15,944
16K028,ps 028 the warren,2009,251,124,127,2,220,2,20
18K637,academy for conservation and the environment,2011,187,93,94,3,159,3,22
31R063,marsh avenue school for expeditionary learning,2009,139,68,71,13,26,68,29
10X319,providing urban learners success in education hi,2010,208,134,74,0,76,2,129
27Q114,ps 114 belle harbor,2007,795,374,421,17,27,711,39
12X341,accion academy,2016,154,74,80,3,39,4,107
04M555,central park east high school,2017,490,323,167,48,122,31,280
02M280,manhattan early college school for advertising,2015,97,47,50,7,31,16,42
11X160,p.s. 160 walt disney,2014,383,185,198,10,214,8,137
75M751,manhattan school for career development,2016,192,58,134,2,85,7,97
75Q224,p.s. q224,2015,434,113,321,82,128,68,128
09X413,bronx high school for medical science,2011,434,259,175,29,156,0,245
31R018,p.s. 018 john g. whittier,2015,637,284,353,19,284,38,286
22K195,p.s. 195 manhattan beach,2014,459,217,242,15,16,412,11
16K594,gotham professional arts academy                ,2012,294,167,127,3,231,2,57
07X551,bronx academy of letters,2007,314,205,109,8,117,1,185
07X548,careers in sports high school,2014,575,85,490,1,164,6,398
10X386,school for environmental citizenship,2011,438,227,211,2,84,3,347
15K429,digital arts and cinema technology high school,2014,275,113,162,6,148,15,98
02M416,eleanor roosevelt high school,2010,498,319,179,90,41,305,49
32K376,ps 376,2008,572,294,278,11,51,12,496
08X519,felisa rincon de gautier institute for law and pub,2016,275,150,125,9,69,5,186
14K297,p.s. 297 abraham stockton,2017,246,112,134,5,96,3,137
02M374,gramercy arts high school,2017,534,386,148,17,219,35,228
13K412,brooklyn community high school of communications,2009,324,156,168,2,272,4,45
19K346,p.s. 346 abe stark,2017,633,307,326,39,391,38,145
32K549,bushwick school for social justice,2008,435,228,207,1,119,2,303
24Q530,international high school at laguardia community,2012,493,266,227,212,10,51,217
31R011,ps 011 thomas dongan,2008,283,127,156,14,56,121,91
08X405,herbert lehman high school,2006,4120,1834,2286,255,922,576,2234
25Q525,townsend harris high school,2007,1093,762,331,524,86,354,129
19K213,p.s. 213 new lots,2015,396,198,198,3,316,11,64
28Q082,ps 082 hammond,2008,573,281,292,224,48,14,287
17K161,p.s. 161 the crown,2016,409,188,221,31,318,7,47
22K134,p.s. k134,2016,549,288,261,223,48,200,71
11X076,p.s. 076 the bennington school,2017,979,462,517,31,445,76,415
08X333,the longwood academy of discovery,2017,413,197,216,2,79,6,322
23K518,kappa v (knowledge and power preparatory academy),2016,192,97,95,2,172,1,15
27Q097,p.s. 097 forest park,2017,747,365,382,137,20,33,542
31R445,port richmond high school,2016,1493,713,780,98,396,319,666
06M314,muscota,2018,292,149,143,13,6,125,127
10X310,ps 310 marble hill                              ,2012,752,369,383,23,78,24,623
12X092,ps 092 bronx,2009,537,255,282,7,151,6,372
01M450,east side community high school                 ,2012,598,271,327,58,143,62,331
26Q203,p.s. 203 oakland gardens,2014,897,421,476,640,20,154,67
17K590,middle college high school at medgar evers colle,2011,1032,584,448,5,996,2,29
03M166,p.s. 166 the richard rodgers school of the arts an,2015,615,316,299,69,41,362,110
06M173,ps 173,2008,821,393,428,15,23,26,757
06M328,ms 328  manhattan middle school for scientific,2009,471,191,280,8,46,4,413
09X252,mott hall bronx high school,2010,385,199,186,5,128,4,243
31R600,ralph r. mckee career and technical education high,2018,792,164,628,41,212,154,368
19K404,academy for young writers,2015,547,357,190,7,394,4,131
84X461,metropolitan lighthouse charter school,2016,426,218,208,2,171,4,242
08X562,blueprint middle school,2016,301,154,147,69,55,3,168
30Q171,ps 171 peter g van alst,2010,650,323,327,155,123,68,303
03M084,ps 084 lillian weber                            ,2012,489,240,249,13,108,137,222
06M278,paula hedbavny school,2016,533,275,258,12,15,89,413
10X445,the bronx high school of science,2014,3037,1297,1740,1891,91,702,195
23K493,brooklyn collegiate: a college board school,2011,598,305,293,13,521,2,57
17K751,academy for health careers,2018,359,243,116,11,281,4,52
29Q195,ps 195 william haberle,2008,712,355,357,16,643,21,29
26Q031,ps 031 bayside                                  ,2012,522,264,258,273,43,91,113
27Q316,queens explorers elementary school,2015,103,54,49,15,12,17,55
12X550,high school of world cultures,2011,379,180,199,16,25,4,283
31R063,marsh avenue school for expeditionary learning,2017,449,251,198,40,30,270,101
25Q670,robert f. kennedy community high school,2006,446,232,214,94,63,158,120
01M458,forsyth satellite academy,2018,203,117,86,1,70,9,121
15K448,brooklyn secondary school for collaborative stud,2011,697,287,410,28,237,94,329
28Q117,p.s. 117 j. keld / briarwood school,2017,1051,495,556,371,109,178,349
12X196,ps 196                                          ,2012,796,406,390,19,165,8,593
04M372,esperanza preparatory academy,2018,559,266,293,12,62,9,475
75K141,p.s. k141,2014,397,133,264,9,201,60,113
17K548,brooklyn school for music & theatre,2011,396,276,120,3,335,3,53
21K096,is 096 seth low,2006,1276,603,673,348,312,383,231
12X245,new day academy                                 ,2012,191,99,92,2,87,0,102
12X251,explorations academy,2010,362,178,184,2,113,5,241
84K707,brooklyn prospect charter school,2015,771,341,430,64,139,302,231
10X440,dewitt clinton high school                      ,2012,4159,2033,2126,278,1282,86,2478
02M690,school for the physical city high school,2007,373,187,186,33,132,16,183
25Q029,ps 029 queens                                   ,2012,664,336,328,199,24,102,338
27Q053,m.s. 053 brian piccolo,2014,351,154,197,6,227,4,113
10X360,ps 360,2010,482,238,244,9,79,14,372
13K256,ps 256 benjamin banneker,2008,421,206,215,5,308,7,90
18K566,brooklyn generation school,2010,220,71,149,6,196,0,15
01M839,tompkins square ms extension,2006,221,113,108,34,34,35,112
30Q228,ps 228 ecc,2006,341,165,176,39,13,20,266
84X487,girls preparatory charter school of the bronx,2015,559,559,0,2,183,2,364
84X429,charter high school for law and social justice,2016,128,77,51,1,15,1,74
02M418,millennium high school,2011,637,396,241,180,59,237,158
09X414,jonathan levin high school for media and communi,2008,484,224,260,10,145,4,320
17K189,ps 189 lincoln terrace,2008,1127,540,587,13,857,4,250
31R022,ps 022 graniteville,2009,1244,611,633,138,298,267,526
11X111,ps 111 seton falls,2008,605,313,292,8,401,4,190
21K525,edward r. murrow high school,2014,4021,2346,1675,1077,921,1144,816
05M685,bread & roses integrated arts high school,2009,526,274,252,2,267,2,253
02M300,urban assembly school of design and construction,2009,384,97,287,17,96,19,250
84X389,bronx global learning institute for girls charter,2015,382,382,0,5,102,2,263
09X218,p.s./i.s. 218 rafael hernandez dual language magne,2014,930,490,440,38,67,4,806
10X284,bronx school of law and finance,2011,408,187,221,1,153,15,239
04M037,river east,2011,219,104,115,2,111,3,101
10X037,p.s. x037 - multiple intelligence school,2015,648,301,347,12,147,13,468
26Q172,irwin altman middle school 172,2007,1095,547,548,562,131,239,161
09X022,j.h.s. 022 jordan l. mott,2014,570,282,288,9,159,5,396
15K051,m.s. 51 william alexander,2018,1136,636,499,186,86,579,232
17K161,p.s. 161 the crown,2017,374,166,208,14,304,7,43
16K584,ms 584,2010,269,131,138,0,236,2,28
17K397,p.s. 397 foster-laurie,2017,203,104,99,7,160,20,13
31R056,ps 56 the louis desario school,2010,769,375,394,28,6,664,59
19K108,p.s. 108 sal abbracciamento,2018,959,468,491,59,107,11,755
10X095,ps 095 sheila mencher,2009,1200,540,660,88,270,66,764
04M083,ps 083 luis munoz rivera,2009,436,213,223,33,141,12,236
03M334,the anderson school,2018,537,266,271,145,15,275,49
09X073,p.s. 073 bronx,2015,827,409,418,1,206,11,608
14K586,lyons community school,2011,544,256,288,4,243,6,288
30Q145,is 145 joseph pulitzer,2011,2039,1015,1024,156,48,20,1812
12X251,explorations academy,2007,218,119,99,2,64,2,144
02M419,landmark high school,2014,396,200,196,21,82,9,280
03M860,frederick douglass academy ii secondary school,2006,389,209,180,1,309,3,68
02M281,the river school,2016,152,72,80,46,14,66,24
31R020,p.s. 020 port richmond,2018,464,230,234,2,79,19,353
21K121,ps 121 nelson a rockefeller,2011,273,139,134,44,8,111,110
05M148,eagle academy for young men of harlem,2017,274,0,274,0,194,3,68
01M361,children's workshop school,2009,254,128,126,33,29,89,85
13K307,ps 307 daniel hale williams,2009,258,132,126,2,180,4,71
79X695,passages academy,2015,395,127,268,6,219,29,137
07X551,the urban assembly bronx academy of letters,2015,591,301,290,5,184,13,388
14K120,p.s. 120 carlos tapia,2017,450,231,219,10,90,7,340
17K537,high school for youth and community development,2011,398,152,246,3,344,4,39
15K010,"magnet school of math, science and design technolo",2016,942,480,462,63,79,458,288
31R065,academy of innovative learning,2011,271,134,137,10,86,97,67
02M459,manhattan international high school,2007,341,184,157,94,47,46,153
13K044,p.s. 044 marcus garvey,2018,139,71,68,4,116,5,13
22K193,ps 193 gil hodges                               ,2012,905,444,461,126,491,136,129
31R027,is 027 anning s prall,2009,1007,447,560,97,237,283,384
23K697,teachers preparatory high school                ,2012,566,373,193,4,480,7,74
27Q253,ps 253,2010,552,260,292,9,293,18,225
28Q680,queens gateway to health sciences secondary school,2017,704,386,318,348,221,27,65
15K497,school for international studies,2011,481,228,253,19,192,70,198
19K218,jhs 218 james p sinnott,2006,1133,564,569,87,603,16,410
10X015,p.s. x015 institute for environmental learning,2014,528,269,259,5,67,1,454
05M517,teachers college community school,2017,273,147,126,11,107,43,95
31R030,ps 030 westerleigh,2008,817,370,447,57,38,579,140
03M421,west prep academy,2017,201,99,102,3,116,7,71
05M046,ps 046 arthur tappan,2006,894,422,472,5,544,11,333
27Q207,ps 207 rockwood park,2008,748,380,368,34,28,591,91
21K225,p.s. k225 - the eileen e. zaglin,2014,907,425,482,156,22,377,346
21K095,ps 095 the gravesend,2011,974,472,502,257,90,277,346
24Q585,maspeth high school,2018,1196,608,588,211,16,382,515
15K442,m.s. 442 carroll gardens school for innovation,2017,211,72,139,10,56,48,95
08X036,ps 036 unionport                                ,2012,732,367,365,116,80,20,502
84M483,new york french american charter school,2014,244,125,119,1,159,40,34
22K198,p.s. 198 brooklyn,2017,447,203,244,15,387,7,34
25Q281,eastwest school of international studies,2010,547,253,294,298,98,25,116
22K152,school of science & technology,2011,842,427,415,63,577,40,155
31R036,ps 036 j c drumgoole,2006,976,463,513,31,6,885,48
07X221,south bronx preparatory: a college board school,2009,590,318,272,7,200,4,376
07X547,new explorers high school,2016,426,243,183,3,121,6,296
02M655,life sciences secondary school,2006,699,396,303,33,237,21,392
31R069,ps 069 daniel d tompkins,2011,915,431,484,129,42,559,164
24Q014,ps 014 fairview,2007,1267,587,680,156,82,74,952
06M366,washington heights academy,2009,133,65,68,7,3,22,100
02M077,ps 77 lower lab school,2008,356,188,168,56,15,233,51
30Q235,academy for new americans                       ,2012,152,74,78,54,2,16,80
31R047,csi high school for international studies,2015,520,296,224,59,46,287,104
84K626,achievement first brownsville charter school,2016,828,441,387,0,732,3,89
25Q281,eastwest school of international studies,2008,356,175,181,187,56,16,86
10X209,p.s. 209,2016,271,145,126,3,41,1,226
16K243,ps 243 weeksville                               ,2012,357,196,161,8,279,2,68
02M425,leadership and public service high school,2008,693,347,346,73,196,37,385
07X161,ps 161 ponce de leon,2011,631,287,344,2,177,5,444
16K688,the brooklyn academy of global finance,2010,101,54,47,0,75,2,21
03M163,ps 163 alfred e smith,2008,639,311,328,20,163,147,307
10X003,ps 3 raul julia micro society,2011,415,204,211,8,119,6,281
84M186,harlem hebrew language charter school,2017,321,148,173,3,97,116,94
18K268,p.s. 268 emma lazarus,2014,459,231,228,5,430,7,17
29Q265,excelsior preparatory high school,2017,494,224,270,15,415,11,34
31R038,ps 038 george cromwell,2010,405,206,199,17,15,271,99
06M528,i.s. 528 bea fuller rodgers school,2018,224,128,96,1,3,0,220
11X418,bronx high school for the visual arts,2009,367,156,211,4,142,29,192
12X550,high school of world cultures,2006,373,196,177,10,23,2,335
03M145,"p.s. 145, the bloomingdale school",2015,391,202,189,5,105,19,251
30Q234,p.s. 234,2018,522,248,274,122,34,158,199
24Q199,ps 199 maurice a fitzgerald,2006,983,469,514,292,8,98,579
25Q242,ps 242,2008,373,187,186,246,19,43,64
17K568,brownsville academy high school,2010,221,125,96,0,189,3,22
07X473,mott haven village preparatory high school,2010,344,168,176,5,90,0,247
06M346,community health academy of the heights,2018,703,345,358,6,46,11,638
27Q282,knowledge and power preparatory academy vi,2016,260,139,121,14,147,7,92
21K097,ps 097 the highlawn,2010,796,414,382,439,9,203,134
03M333,ps 333 manhattan school for children,2006,591,306,285,49,136,266,130
28Q196,ps 196 grand central pkwy,2010,645,314,331,278,17,274,75
21K525,edward r. murrow high school,2016,3885,2282,1603,1001,880,1084,815
25Q237,i.s. 237,2015,1184,550,634,858,89,22,208
13K056,p.s. 056 lewis h. latimer,2017,201,95,106,7,150,16,24
12X341,accion academy,2017,131,67,64,2,33,1,95
14K017,p.s. 017 henry d. woodworth,2017,295,153,142,4,12,32,243
27Q100,ps 100 glen morris                              ,2012,989,427,562,619,101,40,220
31R072,is 072 rocco laurie,2011,1619,766,853,288,298,619,407
02M575,manhattan comprehensive night and day high school,2017,764,331,433,187,229,42,297
31R029,ps 029 bardwell,2007,535,256,279,86,64,312,71
19K502,fdny - captain vernon a. richard high school for f,2018,333,81,252,2,239,3,79
24Q153,ps 153 maspeth elem,2010,1413,707,706,101,16,589,680
04M964,central park east ii,2011,227,115,112,5,99,40,59
02M560,high school m560  city as school,2010,728,380,348,40,269,126,288
11X289,the young scholars academy of the bronx         ,2012,352,155,197,9,235,2,100
32K545,ebc high school for public service_x0016_bushwick,2010,710,353,357,9,78,6,612
84X497,storefront academy charter school,2016,99,41,58,1,38,1,58
04M409,coalition school for social change,2007,425,236,189,3,123,9,276
19K615,transit tech career and technical education high,2008,1664,335,1329,77,1124,18,407
28Q440,forest hills high school,2014,3800,1988,1812,970,348,1197,1220
27Q066,ps 066 jacqueline kennedy onassis,2010,468,239,229,66,45,35,312
08X146,ps 146 edward collins,2011,457,238,219,1,192,2,253
31R042,ps 042 eltingville                              ,2012,988,497,491,41,7,816,113
84K742,explore empower charter school,2017,515,237,278,3,458,4,45
23K156,p.s. 156 waverly,2015,810,378,432,2,648,6,147
15K698,south brooklyn community high school,2014,163,71,92,4,56,9,94
02M565,urban academy laboratory high school,2008,138,77,61,4,53,35,40
31R055,ps 055 henry m boehm,2007,664,327,337,31,7,584,42
21K226,ps 226 alfred de b.mason,2007,748,346,402,199,18,341,184
18K673,east brooklyn community high school,2016,181,87,94,1,146,4,28
12X691,bronx little school,2006,122,63,59,8,33,1,77
21K177,ps 177 the marlboro,2011,903,445,458,294,10,339,257
10X399,ms 399,2008,746,310,436,7,161,2,569
01M650,cascades high school,2016,233,136,97,9,78,15,129
18K219,p.s. 219 kennedy-king,2014,561,280,281,3,501,5,48
84K757,unity prep charter school,2016,316,145,171,5,246,4,54
10X243,west bronx academy for the future               ,2012,636,268,368,22,157,8,442
30Q149,ps 149 christa mcauliffe                        ,2012,1208,586,622,108,15,58,1021
07X224,p.s./i.s. 224,2018,358,156,202,1,94,5,257
17K489,w.e.b. dubois academic high school,2014,131,73,58,3,110,3,13
08X100,p.s. 100 isaac clason,2014,596,292,304,4,216,7,361
84K680,achievement first aspire charter school,2015,241,136,105,1,178,0,56
17K751,academy for health careers,2016,362,253,109,10,300,5,35
10X023,p.s. 023 the new children's school,2016,548,270,278,2,203,3,339
25Q120,ps 120 queens,2008,788,393,395,589,6,33,157
31R022,p.s. 022 graniteville,2017,1018,523,495,76,256,103,555
12X216,bus. schl. entrepren. studies,2009,232,107,125,4,54,0,171
25Q792,north queens community high school,2018,207,94,113,18,87,20,78
02M397,spruce street school,2015,430,204,226,61,11,248,53
09X063,p.s. 063 author's academy,2016,650,343,307,2,234,18,394
04M072,the lexington academy,2017,687,326,361,16,91,18,559
08X301,m.s. 301 paul l. dunbar,2017,237,112,125,0,94,7,136
09X132,p.s. 132 garret a. morgan,2014,492,239,253,1,215,4,270
06M153,p.s. 153 adam clayton powell,2017,676,355,321,16,137,21,495
30Q151,p.s. 151 mary d. carter,2018,381,200,181,62,91,25,197
05M304,mott hall high school,2008,414,201,213,4,139,13,235
28Q338,queens satellite high school for opportunity,2015,226,113,113,12,106,27,67
84M357,success academy charter school - harlem 6,2018,149,76,73,0,91,2,54
32K274,ps 274 kosciusko,2010,736,346,390,24,120,10,574
19K306,p.s. 306 ethan allen,2015,625,303,322,4,469,2,143
29Q195,ps 195 william haberle,2011,696,342,354,15,629,14,37
29Q138,ps 138 sunrise,2006,892,448,444,14,791,14,71
24Q016,p.s. q016 the nancy debenedittis school,2014,1737,828,909,187,11,12,1503
22K206,ps 206 joseph f lamb,2008,1255,619,636,593,75,478,109
31R034,i s 034 tottenville,2011,1140,558,582,34,5,1007,88
09X219,i.s. 219 new venture school,2015,326,148,178,2,114,2,207
02M418,millennium high school,2009,573,358,215,157,75,194,137
31R028,the eagle academy for young men of staten island,2017,192,0,192,15,98,15,60
10X353,world view high school,2017,449,242,207,4,108,6,321
19K507,performing arts and technology high school,2014,428,227,201,1,342,1,82
11X189,cornerstone academy for social action,2010,430,190,240,16,208,10,175
27Q183,p.s. 183 dr. richard r. green,2014,532,268,264,22,282,29,180
25Q025,i s 025 adrien block,2009,889,429,460,417,14,265,189
18K233,ps 233 langston hughes,2009,722,355,367,1,678,5,34
10X086,ps 086 kingsbridge heights,2011,1752,876,876,70,236,29,1416
09X004,p.s./m.s. 004 crotona park west,2017,574,268,306,4,314,5,243
11X016,ps 016 wakefield,2010,633,288,345,56,348,15,181
16K309,ps 309 george e wibecan,2006,475,221,254,20,372,3,75
29Q181,ps 181 brookfield,2009,416,184,232,2,380,11,20
20K768,district 20 pre-k center,2017,1158,569,589,570,12,261,309
09X022,j.h.s. 022 jordan l. mott,2017,419,186,233,2,86,3,325
29Q052,ps 052 queens,2009,598,294,304,14,529,14,35
24Q119,is 119 the glendale,2011,981,445,536,131,18,423,402
09X063,ps 063 author's academy,2009,512,265,247,3,206,2,298
02M312,nyc lab ms for coll. studies,2011,562,284,278,234,25,194,62
84K876,achievement first voyager charter school,2017,66,36,30,2,57,1,2
84M174,success academy union square (manhattan 1),2017,452,224,228,90,105,129,104
02M565,urban academy laboratory high school,2010,145,84,61,4,49,42,42
18K115,p.s. 115 daniel mucatel school,2015,1160,600,560,36,986,33,94
06M052,j.h.s. 052 inwood,2016,411,186,225,2,18,7,381
01M184,ps 184m shuang wen,2008,573,269,304,475,32,41,22
08X301,ms 301 paul l. dunbar ms,2010,326,148,178,1,125,0,199
30Q227,i s 227 louis armstrong,2011,1462,744,718,225,230,474,530
32K116,ps 116 elizabeth l farrell,2010,512,257,255,14,34,11,441
11X357,young voices academy of the bronx,2015,167,72,95,16,24,20,106
27Q137,ms 137 america's schl of heroes,2006,1913,904,1009,961,152,85,691
24Q049,p.s. 049 dorothy bonawit kole,2018,1160,579,581,216,6,645,278
12X388,pan american international high school at monroe,2010,216,100,116,1,0,0,215
08X071,ps 071 rose e scala,2010,1632,808,824,100,98,585,834
04M555,central park east secondary high school,2009,328,175,153,12,117,10,187
30Q127,p.s. 127 aerospace science magnet school,2016,1335,643,692,157,168,23,982
04M072,the lexington academy,2015,563,287,276,7,85,10,459
19K260,ps 260 breuckelen,2011,312,156,156,4,244,4,57
25Q163,ps 163 flushing heights,2006,524,255,269,361,17,38,104
15K463,secondary school for journalism,2015,285,167,118,22,132,18,107
18K208,ps 208 elsa ebeling,2009,647,328,319,6,587,13,38
02M418,millennium high school,2008,548,349,199,150,50,165,122
29Q135,the bellaire school,2015,1021,483,538,386,320,37,191
09X109,p.s. 109 sedgwick,2017,714,325,389,0,133,3,578
27Q066,p.s. 066 jacqueline kennedy onassis,2018,494,237,257,69,26,50,319
25Q024,ps 024 andrew jackson,2007,693,331,362,475,52,37,129
16K081,p.s. 081 thaddeus stevens,2017,315,168,147,15,181,2,104
08X107,ps 107                                          ,2012,523,278,245,8,232,4,272
84K797,new hope academy charter school,2014,368,185,183,0,360,2,3
29Q283,preparatory academy for writers: a college board,2007,105,56,49,1,87,1,12
29Q355,collaborative arts middle school,2015,444,216,228,8,406,5,23
29Q181,p.s. 181 brookfield,2015,417,201,216,7,355,2,43
30Q445,william cullen bryant high school,2016,2437,1111,1326,650,150,374,1226
09X525,bronx leadership academy high school,2017,651,307,344,3,194,7,435
05M362,columbia secondary school,2017,687,348,339,79,157,141,290
14K018,ps 018 edward bush,2009,246,135,111,0,50,6,188
11X076,ps 076 the bennington school,2008,1026,480,546,28,533,27,426
17K539,high school for service & learning at erasmus,2018,354,124,230,9,276,13,48
22K326,ps 326,2006,269,128,141,22,208,11,28
02M408,professional performing arts high school,2010,467,342,125,28,133,198,87
16K040,p.s. 040 george w. carver,2018,318,162,156,14,217,4,69
10X549,discovery high school,2014,542,235,307,14,91,6,427
17K484,ronald edmonds learning center ii,2007,74,31,43,1,68,2,3
28Q690,high school for law enforcement and public safet,2011,529,262,267,36,414,2,75
22K315,p.s. 315 dist 22.,2011,805,418,387,42,590,28,142
23K697,teachers preparatory high school,2008,614,395,219,1,528,6,74
18K114,p.s. 114 ryder elementary,2014,626,308,318,10,535,28,52
84M388,st. hope leadership academy charter school,2014,298,150,148,1,201,0,91
18K066,p.s. 66,2014,777,420,357,3,700,19,51
23K401,christopher avenue community school,2014,244,113,131,1,179,2,58
17K546,high school for public service: heroes of tomorr,2009,404,319,85,6,347,2,49
31R010,fort hill collaborative elementary school,2015,62,23,39,5,21,4,32
20K200,ps 200 benson school,2010,1314,650,664,402,17,624,267
15K519,cobble hill school of american studies,2009,773,413,360,14,528,17,211
22K381,i. s. 381,2006,433,205,228,30,224,101,77
10X237,"the marie curie school for medicine, nursing, and",2017,533,417,116,17,175,15,313
18K563,it takes a village academy,2016,608,246,362,5,543,6,36
06M052,jhs 052 inwood,2007,1115,565,550,9,47,8,1051
08X558,westchester square academy,2015,396,188,208,18,106,35,224
27Q400,august martin high school,2014,853,373,480,64,685,5,89
31R016,p.s. 016 john j. driscoll,2017,557,284,273,30,144,49,329
24Q028,p.s. 28  the thomas emanuel early childhood cen,2009,499,257,242,33,3,8,451
30Q122,p.s. 122 mamie fay,2016,1385,666,719,417,84,534,293
22K251,ps 251 paedergat,2010,661,329,332,29,532,19,68
31R021,ps 21 margaret emeryelm park                   ,2012,468,228,240,14,119,56,276
32K045,ps 045 horace e greene,2006,812,384,428,12,514,7,274
31R042,p.s. 042 eltingville,2016,970,471,499,44,6,779,133
26Q172,irwin altman middle school 172,2006,1125,544,581,586,145,240,152
04M057,james weldon johnson,2015,856,402,454,34,222,18,578
18K114,p.s. 114 ryder elementary,2017,521,256,265,8,419,38,53
19K452,frederick douglass academy viii middle school,2015,289,173,116,18,208,1,61
07X520,foreign language academy of global studies,2008,481,269,212,13,107,5,354
12X061,p.s. 061 francisco oller,2017,293,147,146,2,56,1,230
01M650,cascades high school,2014,222,130,92,3,100,11,107
31R605,staten island technical high school,2014,1235,529,706,446,14,701,67
12X098,j.h.s. 098 herman ridder,2016,199,117,82,2,58,4,134
24Q330,p.s. 330,2015,572,270,302,51,14,6,499
09X263,validus preparatory academy: an expeditionary le,2010,408,272,136,2,158,2,242
05M685,bread & roses integrated arts high school,2006,488,246,242,2,253,3,224
26Q266,p.s./i.s. 266,2011,679,312,367,288,76,193,115
18K235,ps 235 lenox                                    ,2012,1299,705,594,15,1238,9,33
29Q356,community voices middle school,2016,377,185,192,3,342,3,24
24Q610,aviation career & technical education high school,2015,2168,417,1751,668,135,237,1067
07X495,university heights secondary school,2014,466,258,208,11,124,5,325
84K367,success academy charter school - bed-stuy 1,2018,683,345,338,10,469,10,178
01M134,ps 134 henrietta szold,2006,408,198,210,68,98,11,227
24Q113,p.s./i.s. 113 anthony j. pranzo,2018,896,446,450,47,9,455,375
25Q107,ps 107 thomas a dooley,2011,919,425,494,461,9,190,257
22K240,andries hudde,2016,828,413,415,153,518,54,96
09X403,bronx international high school,2007,335,173,162,13,73,12,235
26Q203,p.s. 203 oakland gardens,2016,924,433,491,665,19,140,79
15K462,secondary school for law,2009,580,330,250,29,328,36,181
19K290,p.s. 290 juan morel campos,2014,574,294,280,20,138,8,405
10X360,p.s. 360,2018,490,230,260,10,55,15,410
84X347,international leadership charter high school,2016,349,205,144,3,52,3,276
15K136,i.s. 136 charles o. dewey,2018,485,243,242,37,13,39,394
31R001,ps 001 tottenville,2010,538,273,265,7,8,456,63
17K751,academy for health careers,2015,373,266,107,7,319,2,33
23K646,aspirations diploma plus high school,2015,242,134,108,6,177,4,48
18K272,ps 272 curtis estabrook,2011,720,361,359,15,587,8,100
13K575,bedford stuyvesant preparatory high school,2015,143,92,51,1,122,1,16
19K325,the fresh creek school,2015,249,135,114,0,191,1,55
12X480,bronx regional high school,2010,360,192,168,3,155,2,196
17K191,p.s. 191 paul robeson,2018,170,78,92,3,136,0,26
29Q052,ps 052 queens,2011,534,258,276,10,478,8,38
24Q307,pioneer academy,2010,490,241,249,21,11,3,440
15K010,"magnet school of math, science and design technolo",2018,933,463,470,67,66,471,270
30Q575,academy of american studies,2009,643,366,277,206,67,162,207
19K306,p.s. 306 ethan allen,2016,579,272,307,4,431,3,135
84X346,south bronx classical charter school,2016,440,232,208,6,174,6,251
84K788,achievement first linden elementary school,2016,248,120,128,3,206,1,34
09X449,grant avenue elementary school,2010,137,71,66,2,54,1,61
28Q099,ps 099 kew gardens,2011,801,385,416,225,66,215,290
05M194,ps 194 countee cullen,2006,374,168,206,0,296,4,73
18K563,it takes a village academy,2015,566,237,329,3,511,6,32
08X650,jane addams high school for academic careers,2006,1753,1126,627,23,615,10,1089
01M064,ps 064 robert simon,2006,332,160,172,12,83,8,227
14K478,enterprise business and tech hs,2006,823,342,481,8,237,13,551
02M565,urban academy laboratory high school,2007,131,78,53,5,49,40,32
17K375,ps 375 jackierobinson school,2009,563,272,291,2,455,12,91
24Q877,51 avenue academy (the path to academic excellen,2007,506,242,264,239,8,8,251
11X087,ps 087 bronx,2011,571,273,298,21,416,4,110
31R450,curtis high school,2017,2558,1377,1181,164,938,416,1001
23K697,teachers preparatory high school,2018,250,137,113,5,189,10,44
21K095,p.s. 095 the gravesend,2018,943,465,478,331,77,195,333
30Q555,newcomers high school,2018,911,412,499,270,9,56,570
21K209,p.s. 209 margaret mead,2017,713,365,348,217,27,291,173
28Q072,jhs 072 cath. & count basie,2009,807,378,429,176,510,5,110
15K684,millennium brooklyn hs,2015,566,323,243,54,147,175,154
15K230,p.s. 230 doris l. cohen,2016,1210,571,639,569,18,219,387
28Q470,jamaica high school,2011,1178,509,669,349,573,10,244
09X414,jonathan levin high school for media and communi,2010,445,219,226,3,126,2,312
31R450,curtis high school,2018,2587,1437,1150,166,934,387,1051
08X305,pablo neruda academy for architecture and world ,2012,359,122,237,9,94,5,251
10X442,the celia cruz bronx high school of music,2008,348,211,137,2,113,8,224
27Q253,ps 253,2011,523,258,265,10,257,17,231
06M153,p.s. 153 adam clayton powell,2018,589,295,294,13,102,24,441
20K069,ps 69,2009,834,398,436,607,8,102,116
06M319,m.s. 319 - maria teresa,2017,471,222,249,1,23,9,437
09X297,morris academy for collaborative studies,2018,401,200,201,6,115,4,274
84K355,williamsburg collegiate charter school,2015,521,273,248,1,196,7,315
84X718,bronx charter school for better learning,2014,419,231,188,7,389,1,20
75X754,j. m. rapport school career development,2016,503,168,335,1,176,19,304
09X011,ps 011 highbridge,2006,726,357,369,3,240,2,465
22K535,leon m. goldstein high school for the sciences,2008,1025,551,474,124,171,618,85
30Q078,ps 078                                          ,2012,265,119,146,33,18,97,108
05M046,ps 046 arthur tappan,2008,806,385,421,1,485,6,312
26Q094,ps 094 david d porter,2008,432,200,232,206,12,151,62
10X054,p.s./i.s. 54,2016,504,253,251,10,137,3,352
23K150,ps 150 christopher,2011,295,132,163,3,203,8,79
18K232,is 232 the winthrop,2009,238,110,128,1,226,0,8
17K547,brooklyn academy of science and the environment,2018,373,147,226,19,302,11,35
05M157,the urban assembly school for global commerce,2014,82,33,49,1,40,1,37
11X144,j.h.s. 144 michelangelo,2016,486,235,251,15,316,11,141
31R059,the harbor view school,2017,244,126,118,5,90,31,99
13K011,p.s. 011 purvis j. behan,2017,876,463,413,30,588,98,99
22K222,p.s. 222 katherine r. snyder,2018,932,436,496,199,123,428,161
31R058,s.s. columbia school,2007,759,361,398,150,45,419,144
17K161,ps 161 the crown,2007,979,529,450,8,868,16,80
17K539,high school for service & learning at erasmus,2017,362,122,240,10,284,10,50
01M110,ps 110 florence nightingale,2009,465,239,226,61,73,68,247
22K236,p.s. 236 mill basin,2015,542,271,271,54,110,288,71
10X549,discovery high school,2008,442,216,226,6,112,4,315
16K028,ps 028 the warren,2010,267,129,138,3,228,0,32
04M012,tag young scholars                              ,2012,495,278,217,95,228,22,144
02M439,manhattan village academy,2009,393,255,138,26,110,20,233
01M140,p.s. 140 nathan straus,2016,376,188,188,20,47,13,292
17K408,academy of hospitality and tourism,2014,303,152,151,10,252,3,31
10X213,bronx engineering and technology academy,2011,429,68,361,22,133,4,270
05M304,mott hall high school,2014,425,172,253,4,152,3,260
23K514,frederick douglass academy vii high school,2016,252,110,142,2,222,1,26
11X105,p.s. 105 sen abraham bernstein,2015,1368,684,684,122,171,169,874
10X279,ps 279 capt manuel rivera jr.,2008,1026,470,556,66,192,5,753
09X058,ps 058,2007,421,195,226,9,133,2,273
17K590,middle college high school at medgar evers colle,2008,889,461,428,6,832,4,42
84K473,williamsburg charter high school,2014,969,519,450,3,328,13,620
13K575,bedford stuyvesant preparatory high school,2008,138,72,66,0,116,1,19
32K349,i.s. 349 math science & tech,2011,536,248,288,7,74,5,447
08X071,ps 071 rose e scala,2009,1637,828,809,99,97,635,799
02M655,life sciences secondary school,2011,674,316,358,23,193,11,437
84K774,achievement first apollo charter school,2016,678,352,326,29,459,4,179
26Q188,ps 188 kingsbury,2011,551,253,298,294,20,187,49
01M188,ps 188 the island school                        ,2012,388,177,211,10,104,19,255
07X359,concourse village elementary school,2015,275,122,153,1,92,7,172
75X469,p469x - the bronx school for continuous learners,2016,196,36,160,7,71,8,110
02M280,manhattan early college school for advertising,2018,367,207,160,23,127,29,173
02M425,leadership and public service high school       ,2012,607,327,280,49,185,40,329
14K319,ps 319,2006,171,83,88,5,6,2,157
13K256,p.s. 256 benjamin banneker,2014,355,174,181,6,253,1,95
14K610,automotive high school,2016,372,21,351,10,195,9,152
11X111,p.s. 111 seton falls,2016,753,376,377,2,458,9,273
75Q277,the riverview school,2018,403,98,305,101,72,58,165
18K563,itava it takes a village academy               ,2012,382,195,187,7,355,2,17
27Q106,ps 106,2010,397,197,200,17,294,11,66
05M194,ps 194 countee cullen,2007,338,153,185,1,275,1,61
12X214,p.s. 214,2014,1028,497,531,20,250,19,718
26Q435,martin van buren high school,2011,2542,1170,1372,577,1506,61,380
21K128,ps 128 bensonhurst,2009,362,161,201,105,7,171,79
01M345,collaborative academy of science,2009,292,146,146,44,54,10,182
09X063,ps 063 author's academy,2007,458,212,246,1,200,1,256
24Q014,p.s. 014 fairview,2014,1689,805,884,147,69,29,1428
02M460,washington irving high school,2008,2411,1346,1065,74,791,46,1449
84K759,canarsie ascend charter school,2014,207,94,113,1,189,3,9
10X549,discovery high school,2011,502,235,267,11,115,6,363
03M191,the riverside school for makers and artists,2018,516,231,285,29,162,78,237
28Q117,p.s. 117 j. keld / briarwood school,2018,1016,489,527,359,98,163,352
11X288,collegiate institute for math and science,2018,616,279,337,80,211,64,248
27Q309,academy of medical technology: a college board s,2011,386,232,154,41,211,16,117
02M135,the urban assembly school for emergency management,2015,193,110,83,11,54,5,121
29Q176,p.s. 176 cambria heights,2018,716,373,343,37,504,4,37
06M189,p.s. 189,2014,1123,566,557,2,7,15,1096
09X219,is 219 new venture school,2008,458,206,252,1,210,2,244
26Q435,martin van buren high school,2016,1544,685,859,433,765,53,209
21K216,ps 216 arturo toscanini                         ,2012,545,266,279,123,29,299,93
01M015,p.s. 015 roberto clemente,2018,190,99,91,20,52,6,110
27Q282,knowledge and power preparatory academy vi,2017,259,130,129,12,145,6,95
08X125,jhs 125 henry hudson,2010,701,354,347,158,106,9,427
32K291,jhs 291 roland hayes,2010,658,324,334,7,170,4,472
14K071,juan morel campos secondary school,2006,787,378,409,6,198,41,534
15K169,p.s. 169 sunset park,2015,1661,801,860,852,23,72,711
23K518,kappa v (knowledge and power preparatory academy),2017,200,107,93,2,171,2,21
31R026,p.s. 026 the carteret school,2015,222,117,105,21,9,105,81
21K303,is 303 herbert s. eisenberg,2011,727,384,343,139,109,245,233
24Q058,p.s. 58 - the school of heroes,2016,1029,520,509,396,16,216,396
22K255,ps 255 barbara reing school                     ,2012,833,356,477,191,35,480,118
03M334,the anderson school,2006,506,262,244,93,39,320,51
22K405,midwood high school,2016,3986,2189,1797,1399,1165,889,491
27Q114,p.s./m.s. 114 belle harbor,2014,669,316,353,5,9,601,51
84M336,kipp infinity charter school,2016,1145,585,560,5,339,12,783
12X245,new day academy,2009,479,259,220,0,219,2,257
17K091,ps 091 the albany ave. school                   ,2012,668,292,376,1,616,5,36
07X427,community school for social justice,2014,335,175,160,4,83,1,246
30Q300,the 30th avenue school (g&t citywide),2016,236,122,114,106,13,72,21
08X424,the hunts point school                          ,2012,388,182,206,0,106,6,275
84K689,citizens of the world charter school 1 williamsbur,2015,202,92,110,0,56,19,125
23K599,brooklyn landmark elementary school,2016,239,120,119,5,177,5,52
31R455,tottenville high school,2011,3813,1916,1897,208,74,3137,378
24Q530,international high school at laguardia community,2010,478,252,226,181,6,57,234
84Q372,growing up green charter school ii,2017,224,101,123,23,119,6,71
02M529,jacqueline kennedy onassis high school,2015,676,370,306,27,143,24,475
75X012,p.s. x012 lewis and clark school,2014,246,78,168,5,89,7,144
13K305,ps 305 dr peter ray,2010,360,158,202,8,294,10,45
07X522,bronx design and construction academy           ,2012,138,21,117,3,41,0,93
16K669,research and service high school,2017,265,121,144,2,226,1,33
21K101,p.s. 101 the verrazano,2017,885,428,457,471,5,245,154
12X478,the cinema school,2018,290,174,116,6,63,9,207
17K006,ps 006,2006,679,336,343,2,602,4,68
26Q430,francis lewis high school,2006,4235,2155,2080,1966,570,817,874
10X091,p.s. 091 bronx,2016,760,374,386,20,137,12,581
21K153,ps 153 homecrest,2009,543,255,288,201,12,203,122
20K490,fort hamilton high school,2006,4538,2006,2532,1281,235,1441,1464
09X365,academy for language and technology,2008,110,47,63,0,0,0,110
32K383,j.h.s. 383 philippa schuyler,2014,915,517,398,63,481,24,341
02M260,ms 260 clinton schl writers &                   ,2012,256,170,86,28,31,134,58
13K412,brooklyn community arts & media high school (bcam),2016,379,218,161,4,299,1,70
24Q143,ps 143 louis armstrong                          ,2012,1666,796,870,100,31,6,1528
75R025,south richmond high school i.s./p.s. 25,2016,512,153,359,8,190,150,158
30Q084,p.s. 084 steinway,2015,368,193,175,30,22,172,137
23K599,brooklyn landmark elementary school,2017,311,161,150,6,224,3,74
32K554,all city leadership secondary school,2010,251,114,137,4,46,0,201
13K020,ps 020 clinton hill,2006,451,237,214,7,364,14,55
75X723,p.s. 723,2014,555,136,419,7,227,16,250
29Q156,ps 156 laurelton,2006,798,381,417,3,747,7,38
31R027,i.s. 027 anning s. prall,2016,1038,498,540,102,244,259,414
17K600,clara barton high school,2015,1499,1056,443,24,1351,13,88
10X225,theatre arts production company school,2011,528,345,183,7,134,10,375
15K442,m.s. 442 carroll gardens school for innovation,2018,239,86,153,13,50,80,94
15K107,p.s. 107 john w. kimball,2015,571,297,274,32,33,430,63
05M302,kappa iv,2014,197,86,111,7,116,5,68
13K527,urban assembly institute of math and science for,2011,397,397,0,17,323,8,45
18K617,high school for innovation in advertising and medi,2014,313,105,208,5,270,10,24
04M406,global technology preparatory,2017,134,56,78,4,63,0,67
84Q340,challenge preparatory charter school,2017,690,386,304,7,554,13,102
02M298,pace high school,2006,208,100,108,80,49,11,48
19K325,the fresh creek school,2014,198,102,96,0,151,3,44
02M565,urban academy laboratory high school            ,2012,157,93,64,8,53,32,60
06M128,p.s. 128 audubon,2014,603,282,321,1,18,3,581
12X682,fannie lou hamer freedom high school,2007,473,239,234,3,153,1,307
84K037,beginning with children charter school ii,2017,304,171,133,5,85,5,207
12X262,bronx high school for performance & stagecraft,2007,313,248,65,4,148,2,153
08X269,bronx studio school for writers and artists,2006,154,81,73,0,36,0,118
11X481,the steam bridge school,2016,70,24,46,0,18,13,37
09X204,ps 204 morris heights                           ,2012,456,238,218,0,148,1,300
08X366,urban assembly academy of civic engagement      ,2012,243,112,131,17,53,17,150
16K393,frederick douglass academy iv secondary school,2008,470,238,232,6,397,0,53
08X146,p.s. 146 edward collins,2014,461,226,235,6,203,2,244
84K649,la cima charter school,2014,376,186,190,12,285,9,65
11X180,i s 180 daniel hale williams                    ,2012,852,470,382,28,595,16,209
22K109,ps 109,2011,601,297,304,5,458,10,128
19K108,ps 108 sal abbracciamento,2008,971,475,496,84,210,7,669
12X196,ps 196,2006,402,188,214,13,120,1,263
84M704,harbor science and arts charter school,2015,271,145,126,8,158,4,95
84K738,new visions charter high school for advanced math,2015,247,98,149,9,199,4,21
19K583,multicultural high school,2011,415,207,208,0,4,0,411
09X042,ps 042 claremont,2011,544,255,289,5,235,8,296
27Q650,"high school for construction trades, engineering a",2015,959,299,660,339,104,118,341
26Q266,p.s./i.s. 266,2017,662,318,344,283,111,101,150
25Q032,p.s. 032 state street,2018,980,500,480,688,8,97,163
10X159,p.s. 159 luis munoz marin biling,2017,193,101,92,0,17,3,172
84K362,hellenic classical charter school,2015,494,259,235,8,150,132,191
31R039,ps 39 francis j murphy jr.,2007,483,257,226,61,17,276,122
29Q251,ps 251 queens,2008,410,219,191,6,383,11,7
02M002,p.s. 002 meyer london,2018,552,261,291,434,29,5,82
21K288,ps 288 the shirley tanyhill,2011,553,282,271,12,298,19,218
28Q325,hillside arts & letters academy,2014,420,229,191,115,171,18,93
30Q227,i s 227 louis armstrong                         ,2012,1617,817,800,230,251,464,669
30Q070,ps 070 queens,2011,1099,505,594,228,25,394,445
07X224,p.s./i.s. 224,2015,362,173,189,0,84,7,267
21K288,ps 288 the shirley tanyhill,2006,646,318,328,6,341,27,269
10X046,ps 046 edgar allan poe,2010,1291,629,662,40,235,15,975
10X059,ps 059 the comm school of tec,2009,551,285,266,7,142,6,393
30Q145,i.s. 145 joseph pulitzer,2017,1865,896,969,163,28,26,1639
03M208,ps 208 alain l locke,2010,206,100,106,5,136,3,60
13K595,bedford academy high school,2018,364,193,169,12,281,11,39
84M100,neighborhood charter school of harlem,2017,375,171,204,5,190,11,164
02M520,murry bergtraum high school for business careers,2016,598,291,307,65,284,13,229
31R038,p.s. 038 george cromwell,2015,370,193,177,25,16,204,122
21K329,p.s. 329 surfside,2014,443,212,231,21,273,28,121
18K279,p.s. 279 herman schreiber,2014,532,273,259,5,485,8,27
13K266,ms 266 park place comm. ms                      ,2012,189,90,99,1,145,1,42
20K170,ralph a. fabrizio school,2015,1002,472,530,431,12,356,195
09X241,urban assembly school for applied math and science,2014,605,300,305,9,201,8,385
29Q326,cambria heights academy                         ,2012,147,66,81,5,128,3,11
13K044,ps 044 marcus garvey,2007,601,307,294,20,534,3,43
84K648,bedford stuyvesant collegiate charter school,2018,354,163,191,5,223,2,115
14K449,brooklyn latin,2009,183,81,102,48,62,20,45
02M051,p.s. 051 elias howe,2015,350,172,178,74,43,60,166
11X544,high school for contemporary arts,2014,518,235,283,4,192,5,314
05M046,p.s. 046 arthur tappan,2018,661,338,323,4,322,5,322
28Q196,p.s. 196 grand central parkway,2017,959,483,476,355,25,381,129
14K586,lyons community school,2015,520,231,289,6,201,10,301
07X527,bronx leadership academy ii high school,2007,402,217,185,3,168,6,185
07X551,the urban assembly bronx academy of letters,2014,584,319,265,4,170,6,401
31R056,ps 56 the louis desario school,2009,766,384,382,28,7,665,57
28Q687,queens high school for sciences at york college,2010,415,196,219,275,60,41,39
29Q181,p.s. 181 brookfield,2016,389,180,209,6,334,2,32
29Q131,ps 131 abigail adams                            ,2012,826,421,405,613,86,42,76
08X138,ps 138 samuel randall                           ,2012,967,467,500,16,296,4,631
18K211,i.s. 211 john wilson,2017,539,262,277,5,464,10,55
02M006,ps 006 lillie d. blake,2010,793,370,423,66,27,561,79
32K151,ps 151 lyndon b johnson,2006,525,253,272,4,127,3,387
24Q087,ps 087 middle village                           ,2012,583,285,298,28,9,260,263
06M223,i s 223 mott hall,2010,370,212,158,11,19,9,330
18K208,ps 208 elsa ebeling,2006,719,357,362,1,664,13,38
24Q267,high school of applied communication,2018,417,230,187,48,37,63,253
01M188,p.s. 188 the island school,2017,445,195,250,10,141,15,278
17K012,dr. jacqueline peek-davis school,2015,215,102,113,3,171,4,36
15K131,ps 131 brooklyn,2009,858,439,419,255,7,55,541
26Q041,ps 041 crocheron,2011,503,226,277,215,12,199,73
02M393,the business of sports school,2011,210,55,155,7,74,8,120
18K598,middle school of marketing and legal studies,2008,87,42,45,0,78,1,8
30Q145,i.s. 145 joseph pulitzer,2016,1925,943,982,155,27,29,1709
75Q177,p.s. q177,2014,493,114,379,78,168,124,113
75K368,p.s. 368,2014,263,49,214,3,145,21,92
84K777,ocean hill collegiate charter school,2014,256,130,126,4,232,4,13
02M313,"james baldwin school, the: a school for expedition",2016,265,142,123,2,118,13,129
13K020,p.s. 020 clinton hill,2015,377,182,195,16,218,60,68
31R026,ps 026 the carteret school,2009,190,94,96,11,12,102,63
29Q109,jean nuzzi intermediate school,2008,1470,722,748,408,723,27,290
27Q317,waterside children's studio school,2014,441,229,212,9,128,94,193
27Q225,ps 225 seaside,2007,692,340,352,20,319,120,226
14K297,ps 297 abraham stockton,2008,403,196,207,2,220,13,166
06M115,ps 115 alexander humboldt,2007,953,467,486,4,21,9,915
31R032,ps 032 the gifford school,2008,890,421,469,34,11,755,79
24Q014,ps 014 fairview,2011,1518,738,780,160,70,57,1227
29Q313,benjamin franklin high school for finance & inform,2018,397,134,263,60,248,10,59
04M435,manhattan center for science and mathematics,2018,1625,807,816,312,299,80,884
04M555,central park east secondary high school,2010,332,186,146,16,106,7,194
31R019,ps 019 the curtis school,2008,660,318,342,44,127,114,369
08X123,j.h.s. 123 james m. kieran,2016,343,179,164,4,71,1,267
25Q540,queens academy high school,2018,371,139,232,41,141,18,158
23K493,brooklyn collegiate: a college board school,2015,353,134,219,5,308,2,34
02M416,eleanor roosevelt high school,2016,554,328,226,119,22,344,47
02M111,p.s. 111 adolph s. ochs,2015,465,236,229,69,76,53,257
14K017,ps 017 henry d woodworth,2011,394,186,208,17,24,27,323
09X449,grant avenue elementary school,2017,444,209,235,20,126,9,276
23K643,brooklyn democracy academy,2009,151,81,70,1,134,1,14
13K483,the urban assembly school for law and justice,2007,319,218,101,4,211,4,69
19K507,performing arts and technology high school      ,2012,453,220,233,3,369,0,79
17K546,high school for public service: heroes of tomorrow,2017,460,304,156,21,347,5,79
30Q152,p.s. 152 gwendoline n. alleyne school,2016,1257,627,630,623,9,50,559
27Q056,p.s. 056 harry eichler,2018,387,194,193,140,18,48,160
17K353,elijah stroud middle school,2010,151,67,84,3,127,2,17
18K135,p.s. 135 sheldon a. brookner,2018,574,292,282,7,463,46,49
21K199,p.s. 199 frederick wachtel,2017,521,258,263,122,23,250,121
09X163,ps 163 arthur a schomburg,2011,687,364,323,5,208,3,463
24Q296,pan american international high school,2014,367,175,192,1,0,0,366
07X379,jill chaifetz transfer high school,2009,131,70,61,1,70,1,58
04M635,academy of environmental science secondary high,2007,714,330,384,3,228,3,478
26Q221,ps 221 north hills,2009,655,345,310,444,12,138,56
25Q032,p.s. 032 state street,2017,974,479,495,659,10,106,177
27Q105,ps 105 the bay school,2011,944,464,480,23,599,16,302
02M130,p.s. 130 hernando de soto,2017,962,473,489,849,10,32,46
02M234,p.s. 234 independence school,2015,729,362,367,84,7,512,55
28Q220,p.s. 220 edward mandel,2017,707,353,354,198,60,264,163
13K575,bedford stuyvesant preparatory high school,2017,122,63,59,0,100,1,19
06M322,middle school 322,2008,511,225,286,0,23,3,485
01M020,p.s. 020 anna silver,2017,540,265,275,175,52,27,264
08X337,the school for inquiry and social justice,2018,518,251,267,10,123,3,372
04M007,p.s. 007 samuel stern,2014,391,189,202,13,102,17,252
11X544,high school for contemporary arts,2008,432,230,202,4,207,3,215
18K500,canarsie high school,2006,2885,1270,1615,48,2401,60,331
02M183,ps 183 robert l stevenson,2010,645,305,340,96,39,384,68
24Q071,ps 071 forest,2010,991,481,510,57,12,454,449
18K219,p.s. 219 kennedy-king,2015,564,284,280,8,491,4,54
05M157,the urban assembly school for global commerce,2018,241,116,125,4,112,5,115
30Q069,ps 069 jackson heights,2006,1162,564,598,494,12,152,499
10X159,ps 159 luis munoz marin biling,2010,219,105,114,1,24,0,187
10X307,luisa pineiro fuentes school of science and discov,2015,409,209,200,31,39,5,333
21K288,p.s. 288 the shirley tanyhill,2018,663,320,343,11,397,39,213
09X403,bronx international high school,2015,409,204,205,14,82,7,303
10X243,west bronx academy for the future,2015,599,269,330,15,120,14,446
12X341,accion academy,2018,151,72,79,1,37,3,110
08X125,jhs 125 henry hudson,2008,757,367,390,162,134,13,448
84K536,community roots charter school,2015,453,214,239,15,177,174,55
18K208,ps 208 elsa ebeling,2010,626,333,293,4,574,16,29
17K167,ps 167 the parkway                              ,2012,463,221,242,2,394,10,56
29Q134,ps 134 hollis                                   ,2012,508,236,272,27,434,10,36
11X542,pelham preparatory academy,2007,450,264,186,19,193,29,180
18K115,p.s. 115 daniel mucatel school,2014,1172,593,579,36,1002,37,84
04M825,isaac newton jhs for science & math,2006,267,121,146,2,65,2,194
05M133,p.s. 133 fred r moore,2018,211,69,142,6,102,11,89
19K659,cypress hills collegiate preparatory school,2016,232,107,125,16,48,10,153
28Q284,york early college academy,2008,162,76,86,23,115,3,17
21K098,is 98 bay academy,2009,1051,567,484,223,129,608,88
27Q207,p.s. 207 rockwood park,2016,721,341,380,20,11,542,137
21K095,ps 095 the gravesend,2006,898,445,453,256,76,292,271
84M482,success academy charter school - harlem 5,2015,517,265,252,5,341,3,154
14K577,conselyea preparatory school,2009,390,195,195,13,47,83,245
03M307,the urban assembly school for media studies,2010,368,161,207,5,152,13,193
31R861,staten island school of civic leadership,2015,855,422,433,100,183,202,343
25Q252,the queens school of inquiry,2008,242,121,121,108,34,37,62
31R049,i.s. 49 berta a. dreyfus,2014,795,372,423,91,281,103,314
11X265,bronx lab school,2017,415,164,251,11,179,11,208
31R026,p.s. 026 the carteret school,2017,242,133,109,25,5,130,78
29Q192,i.s. 192 the linden,2014,528,250,278,7,486,6,26
18K068,i.s. 068 isaac bildersee,2016,464,208,256,4,416,14,25
19K149,ps 149 danny kaye,2011,788,406,382,11,538,5,231
30Q280,p.s. 280,2017,723,344,379,51,8,8,650
25Q525,townsend harris high school,2018,1141,801,340,662,59,231,123
10X008,ps 008 issac varian,2008,1157,582,575,85,160,92,808
19K502,fdny - captain vernon a. richard high school for f,2015,324,77,247,4,233,5,79
22K222,p.s. 222 katherine r. snyder,2014,865,420,445,178,133,393,144
31R018,ps 018 john g whittier,2008,541,255,286,6,258,24,247
11X083,p.s. 083 donald hertz,2016,1721,868,853,166,150,549,844
31R050,ps 050 frank hankinson,2007,544,255,289,35,14,436,56
29Q496,business computer applications & entrepreneurshi,2011,364,110,254,22,307,5,19
02M565,urban academy laboratory high school,2009,147,90,57,3,52,43,41
30Q212,ps 212,2008,737,396,341,112,17,73,535
84X380,success academy charter school - bronx 3,2018,515,248,267,3,272,2,226
05M286,is 286 renaissance mil/ldrshp,2009,206,99,107,3,108,0,94
02M500,unity center for urban technologies,2006,203,107,96,3,98,3,96
27Q183,ps 183 dr. richard r. green,2008,659,341,318,35,433,24,151
30Q127,p.s. 127 aerospace science magnet school,2014,1462,719,743,178,204,16,1058
11X542,pelham preparatory academy,2008,460,260,200,20,195,22,188
11X513,new world high school,2011,368,194,174,45,59,9,253
21K177,p.s. 177 the marlboro,2014,952,481,471,254,8,378,292
01M292,orchard collegiate academy,2016,185,68,117,22,49,6,106
09X303,i.s. x303 leadership & community service,2014,325,157,168,0,78,2,245
84X389,bronx global learning institute for girls charter,2014,347,347,0,7,101,3,228
04M610,young women's leadership school,2017,482,482,0,43,115,20,292
04M083,p.s. 083 luis munoz rivera,2014,460,220,240,50,106,15,283
28Q328,high school for community leadership,2017,476,228,248,118,176,26,119
24Q296,pan american international high school,2017,498,239,259,0,0,0,497
14K610,automotive high school,2017,337,17,320,12,165,10,143
20K185,ps 185 walter kassenbrock,2008,793,368,425,125,5,556,107
30Q171,p.s. 171 peter g. van alst,2018,503,249,254,93,137,31,232
31R036,p.s. 036 j. c. drumgoole,2016,920,458,462,52,2,744,107
01M361,children's workshop school,2008,258,134,124,34,30,102,81
20K204,ps 204 vince lombardi,2006,1007,470,537,326,10,565,101
12X521,the metropolitan soundview high school,2017,423,199,224,14,109,8,287
25Q169,p.s. 169 bay terrace,2016,423,202,221,144,19,168,86
10X094,ps 094 kings college school,2009,930,464,466,134,211,21,546
30Q204,is 204 oliver w holmes,2008,883,416,467,164,192,53,472
25Q540,queens academy high school,2017,435,162,273,42,168,24,185
01M448,university neighborhood high school,2011,488,213,275,110,128,18,232
84K741,success academy crown heights (brooklyn 7),2015,235,119,116,0,216,1,14
04M155,ps 155 william paca,2008,388,182,206,4,62,3,319
02M308,lower manhattan arts academy,2006,83,46,37,7,39,3,30
02M289,is 289,2009,298,160,138,120,36,93,48
02M158,ps 158 bayard taylor,2007,723,358,365,80,43,458,132
30Q127,ps 127 aerospace science magne,2009,1197,562,635,92,271,37,788
24Q119,is 119 the glendale                             ,2012,901,407,494,184,22,333,353
11X566,pelham gardens middle school,2017,469,239,230,12,288,14,143
17K489,w.e.b. dubois academic high school              ,2012,199,108,91,2,186,1,8
06M128,p.s. 128 audubon,2018,586,286,300,11,9,11,551
11X121,p.s. 121 throop,2015,980,498,482,63,622,27,260
08X337,the school for inquiry and social justice,2014,319,157,162,3,116,1,199
19K158,ps 158 warwick,2006,514,238,276,2,288,2,217
04M206,p.s. 206 jose celso barbosa,2016,484,218,266,19,126,29,295
31R009,naples street elementary school,2017,262,123,139,14,44,123,73
30Q227,i.s. 227 louis armstrong,2015,1642,851,791,232,199,435,761
09X505,bronx school for law government and justice,2008,594,363,231,17,218,7,335
11X016,ps 016 wakefield,2011,611,278,333,59,337,14,176
27Q254,ps 254,2007,491,233,258,104,38,43,303
07X670,health opportunities high school,2015,554,361,193,17,202,9,319
19K404,academy for young writers,2017,566,349,217,6,396,5,146
30Q152,p.s. 152 gwendoline n. alleyne school,2018,1104,545,559,601,4,39,444
16K267,ms 267 math science & tech                      ,2012,339,136,203,8,254,2,64
84K357,kipp amp charter school,2015,841,443,398,0,651,6,170
29Q036,ps 036 st albans school,2011,462,225,237,2,427,8,22
11X103,ps 103 hector fontanez,2008,1082,523,559,28,617,23,399
75Q177,p.s. q177,2017,489,112,377,89,150,130,111
05M036,ps 036 margaret douglas,2009,503,258,245,9,269,10,210
32K168,the brooklyn school for math and research,2018,269,107,162,15,127,11,109
84X394,mott haven academy charter school,2015,294,154,140,1,88,1,198
09X303,i.s. x303 leadership & community service,2017,320,162,158,2,74,1,241
23K644,eagle academy for young men ii,2011,212,0,212,0,189,3,20
02M460,washington irving high school,2009,1676,905,771,66,529,29,1035
24Q550,high school for arts and business,2016,823,464,359,79,75,31,634
06M189,ps 189,2008,1114,582,532,1,3,5,1105
04M108,ps 108 assmbly angelo del toro,2010,729,357,372,20,233,8,458
13K439,brooklyn international high school,2016,362,182,180,113,67,50,131
04M171,ps 171 patrick henry                            ,2012,656,304,352,31,187,14,412
02M260,m.s. 260 clinton school writers & artists,2018,604,412,192,76,28,387,69
13K008,p.s. 008 robert fulton,2016,924,459,465,56,129,565,106
20K205,p.s. 205 clarion,2016,1181,575,606,665,10,267,238
31R024,i s 024 myra s barnes,2010,1471,708,763,49,16,1229,154
84K417,urban dove charter school,2016,298,125,173,3,229,2,61
02M294,high school for history & communication,2008,343,164,179,21,88,36,194
11X265,bronx lab school                                ,2012,482,195,287,13,182,8,276
24Q530,international high school at laguardia community c,2017,530,292,238,154,13,64,295
30Q126,albert shanker school for visual and performing,2008,646,304,342,116,121,43,362
01M539,new explorations into science tech and math,2008,1063,572,491,238,103,551,163
03M149,ps 149 sojourner truth,2006,336,159,177,2,257,1,74
11X178,p.s. 178 - dr. selman waksman,2015,491,218,273,10,307,29,134
15K172,ps 172 beacon sch of excellen,2007,548,270,278,14,16,80,435
04M610,young women's leadership school,2006,398,398,0,6,136,5,246
17K191,p.s. 191 paul robeson,2017,192,92,100,4,155,2,25
14K640,harry van arsdale h.s.,2008,17,10,7,0,12,1,4
31R036,ps 036 j c drumgoole,2010,898,430,468,34,6,792,63
09X263,validus preparatory academy: an expeditionary le,2011,370,237,133,4,133,2,228
03M247,ms 247m dual language mid. sch,2007,165,79,86,0,0,0,165
10X439,bronx high school for law and community service,2010,451,264,187,10,168,5,262
31R058,s.s. columbia school                            ,2012,783,380,403,131,45,434,168
27Q105,ps 105 the bay school,2006,754,389,365,18,495,7,226
31R016,p.s. 016 john j. driscoll,2015,620,299,321,34,136,80,366
26Q178,ps 178 holliswood                               ,2012,502,247,255,93,40,283,83
30Q222,p.s. q222 - fire fighter christopher a. santora sc,2014,343,187,156,43,4,26,260
84K517,leadership prep bedford stuyvesant uncommon prep c,2014,620,322,298,5,550,3,55
12X190,e.s.m.t- i.s. 190,2018,241,121,120,4,53,2,177
75K372,p.s. 372 -the children's school,2015,198,44,154,9,44,97,45
11X287,north bronx school of empowerment,2014,250,123,127,0,178,0,68
84K360,launch expeditionary learning charter school,2016,311,143,168,0,258,2,48
09X313,i.s. 313 school of leadership development,2016,309,146,163,3,100,0,206
75K372,p.s. 372 -the children's school,2016,208,45,163,10,45,98,50
02M033,ps 033 chelsea school,2009,323,154,169,44,78,35,161
30Q230,intermediate school 230,2006,1056,496,560,351,28,79,598
09X250,eximius college preparatory academy: a college boa,2017,433,223,210,9,167,3,249
24Q455,newtown high school,2010,3060,1275,1785,670,276,150,1940
20K048,ps 048 mapelton,2011,649,312,337,345,7,159,136
27Q282,knowledge and power preparatory academy vi,2015,263,150,113,15,151,8,88
29Q033,ps 033 edward m. funk,2009,1012,501,511,392,274,60,260
03M403,the global learning collaborative,2018,436,202,234,10,107,18,292
22K425,james madison high school,2008,3828,1758,2070,616,1026,1618,563
28Q470,jamaica high school                             ,2012,564,232,332,175,235,6,146
04M007,p.s. 007 samuel stern,2016,372,173,199,12,112,14,229
08X036,p.s. 036 unionport,2017,743,358,385,175,72,23,453
02M542,manhattan bridges high school,2007,419,204,215,3,3,0,412
12X316,kappa iii,2014,338,184,154,6,105,5,218
02M300,"urban assembly school of design and construction,",2014,427,116,311,27,133,13,253
28Q139,p.s. 139 rego park,2017,773,359,414,182,14,325,236
21K329,p.s. 329 surfside,2017,443,207,236,28,252,27,133
11X513,new world high school,2015,408,224,184,56,38,32,270
18K633,high school for medical professions,2014,441,321,120,12,360,1,60
09X110,ps 110 theodore schoenfeld,2007,505,253,252,0,239,4,259
19K311,essence school,2010,240,132,108,4,198,1,37
10X213,bronx engineering and technology academy,2015,417,68,349,28,143,6,233
13K003,p.s. 003 the bedford village,2017,431,212,219,46,313,10,41
25Q129,ps 129 patricia larkin,2011,992,525,467,305,22,209,450
19K510,world academy for total community health high scho,2015,284,170,114,7,214,4,55
04M038,ps 38 roberto clemente,2010,307,152,155,13,84,8,197
32K299,ps 299 thomas warren field,2007,497,259,238,4,289,6,184
18K114,ps 114 ryder elementary                         ,2012,663,326,337,8,565,27,63
13K419,"science skills center high school for science, tec",2016,549,248,301,34,394,13,96
02M042,ps 042 benjamin altman,2009,747,366,381,686,19,3,37
26Q315,business technology early college high school,2017,322,83,239,95,114,22,66
04M171,p.s. 171 patrick henry,2015,728,355,373,37,182,28,474
02M529,jacqueline kennedy onassis high school,2007,691,427,264,35,179,27,439
27Q096,p.s. 096,2014,322,166,156,129,88,9,46
07X184,i s 184 rafael c y molina,2008,5,2,3,0,0,0,5
13K265,jhs 265 susan s. mckinney,2008,600,345,255,6,480,8,101
08X302,ms 302 luisa dessus cruz ms,2007,918,442,476,4,189,11,709
12X286,fannie lou hamer middle school,2014,251,130,121,3,73,1,171
02M519,talent unlimited high school,2017,495,401,94,20,163,78,202
28Q161,ps 161 arthur ashe school,2010,810,374,436,553,78,27,146
16K688,the brooklyn academy of global finance,2015,152,63,89,10,109,3,30
27Q223,ps 223 lyndon b johnson,2007,661,336,325,51,534,7,62
06M278,paula hedbavny school,2015,538,267,271,17,14,84,419
11X076,ps 076 the bennington school                    ,2012,1044,516,528,41,535,38,427
01M019,p.s. 019 asher levy,2017,271,127,144,24,51,15,180
08X072,ps 072 dr william dorney,2006,998,491,507,43,266,102,582
19K346,p.s. 346 abe stark,2015,635,323,312,35,413,31,144
31R030,p.s. 030 westerleigh,2017,812,401,411,55,21,511,200
31R056,ps 56 the louis desario school,2007,747,370,377,25,7,660,48
27Q465,far rockaway high school,2008,843,436,407,29,506,13,295
27Q114,ps 114 belle harbor,2008,824,388,436,18,29,732,44
07X043,p.s. 043 jonas bronck,2018,471,248,223,2,125,5,338
13K020,ps 020 clinton hill,2010,366,184,182,6,264,27,60
11X508,bronxdale high school                           ,2012,95,38,57,4,22,12,54
09X053,ps 053 basheer quisim                           ,2012,1372,680,692,17,437,12,901
02M041,p.s. 041 greenwich village,2015,757,388,369,71,16,518,72
06M018,p.s. 018 park terrace,2015,396,188,208,1,2,3,390
07X161,p.s. 161 juan ponce de leon school,2015,529,244,285,4,119,10,394
20K204,ps 204 vince lombardi,2007,984,481,503,353,6,512,112
75M226,p.s. m226,2017,268,56,212,11,91,26,134
23K645,ebc/eny high school for public safety & law,2006,520,261,259,2,292,5,210
10X015,ps 015 inst for enviro. lrng.,2010,577,301,276,6,81,2,487
07X221,south bronx preparatory: a college board school,2017,657,345,312,12,153,11,474
05M129,p.s. 129 john h. finley,2018,435,194,241,15,211,5,193
17K246,is 246 walt whitman,2011,602,271,331,3,504,2,90
08X062,p.s. 062 inocensio casanova,2018,708,313,395,1,141,15,547
24Q005,i.s. 5 - the walter crowley intermediate school,2016,1825,908,917,799,32,44,946
75X721,p.s. x721 - stephen mcsweeney school,2018,528,185,343,12,184,26,301
10X445,bronx high school of science,2009,2808,1223,1585,1723,114,750,211
02M150,p.s. 150,2016,184,87,97,29,10,101,25
08X071,p.s. 071 rose e. scala,2014,1698,832,866,119,65,468,1029
84K774,achievement first apollo charter school,2015,578,311,267,22,395,2,155
24Q089,p.s. 089 elmhurst,2017,1995,998,997,426,2,35,1518
11X272,globe school for environmental research,2006,209,89,120,9,137,5,57
84K395,new visions a.i.m. charter high school i,2017,223,102,121,1,142,4,57
01M188,p.s. 188 the island school,2018,433,185,248,8,127,12,286
02M312,nyc lab ms for coll. studies                    ,2012,575,281,294,256,22,194,62
32K116,ps 116 elizabeth l farrell,2011,507,254,253,13,31,13,450
10X015,ps 015 inst for enviro. lrng.,2007,573,307,266,13,92,2,462
09X231,eagle academy for young men,2015,608,0,608,1,364,2,231
27Q465,far rockaway high school,2006,1099,525,574,44,707,24,315
17K394,ms 394k,2007,812,435,377,3,764,4,37
02M303,the facing history school,2008,320,149,171,10,104,6,197
21K559,life academy high school for film and music,2010,153,81,72,5,64,21,59
17K625,paul robeson high school,2009,1176,478,698,6,1043,8,103
06M540,a. philip randolph campus high school,2017,1447,717,730,77,424,36,872
25Q185,j.h.s. 185 edward bleeker,2015,1523,729,794,822,64,183,444
19K364,i s 364 gateway,2007,436,221,215,8,315,21,91
07X527,bronx leadership academy ii high school,2009,453,222,231,5,171,4,267
09X339,is 339 school of comm. tech.,2007,914,447,467,10,278,2,614
32K545,ebc high school for public service - bushwick,2017,511,245,266,2,43,7,457
04M013,jhs 013 jackie robinson,2010,309,138,171,6,117,5,177
02M059,ps 059 beekman hill intl,2006,396,202,194,61,38,211,83
05M092,p.s. 092 mary mcleod bethune,2016,297,135,162,2,181,10,102
02M305,the urban assembly academy of government and law,2006,82,38,44,5,32,9,35
03M541,manhattan/hunter science high school,2010,437,231,206,124,83,46,171
08X014,p.s. x014 senator john calandra,2016,599,285,314,23,33,143,392
30Q227,i s 227 louis armstrong,2010,1483,755,728,238,223,482,539
26Q205,ps 205 alexander graham bell                    ,2012,330,158,172,143,18,109,54
07X427,community school for social justice,2006,338,193,145,1,123,6,199
14K582,ms 582,2010,318,153,165,3,69,6,237
28Q072,jhs 072 cath. & count basie,2010,804,382,422,161,534,6,95
14K474,progress high school for professional careers,2010,981,529,452,12,311,11,641
10X003,ps 3 raul julia micro society,2009,461,222,239,8,157,3,283
11X097,ps 097 bronx,2008,741,345,396,66,328,100,242
29Q283,preparatory academy for writers: a college board,2009,299,167,132,8,243,4,42
28Q050,ps 050 talfourd lawn elementary school          ,2012,783,406,377,110,235,19,311
18K673,east brooklyn community high school,2014,187,105,82,1,157,1,28
28Q206,ps 206 horace harding,2008,644,294,350,139,156,174,170
31R057,ps 057 hubert h humphrey                        ,2012,693,331,362,20,350,78,238
09X328,new millennium business academy middle school,2008,259,128,131,3,100,2,152
02M420,high school for health professions and human servi,2017,1792,1252,540,358,303,145,950
21K400,lafayette high school,2009,324,148,176,85,129,35,71
10X118,jhs 118 william w niles,2009,1166,621,545,108,269,26,758
30Q204,i.s. 204 oliver w. holmes,2014,704,317,387,173,124,61,339
22K312,ps 312 bergen beach,2007,881,413,468,42,244,515,76
32K291,j.h.s. 291 roland hayes,2015,403,195,208,8,60,13,321
18K276,ps 276 louis marshall                           ,2012,785,357,428,7,730,7,18
27Q043,ps 043                                          ,2012,1246,616,630,28,823,28,344
14K023,ps 023 carter c woodson,2008,342,157,185,4,183,2,152
31R008,ps 8 shirlee solomon,2006,448,195,253,9,5,386,46
29Q289,queens united middle school,2015,148,73,75,1,126,1,9
19K290,ps 290 juan morel campos,2011,584,286,298,24,151,4,404
09X413,bronx high school for medical science,2017,410,225,185,35,119,6,244
84X208,new visions charter high school for the humanities,2018,488,255,233,6,191,2,279
09X170,p.s. 170,2014,283,143,140,5,63,7,205
09X219,i.s. 219 new venture school,2014,373,183,190,3,147,0,222
13K674,"city polytechnic high school of engineering, archi",2016,451,105,346,28,324,16,79
02M529,jacqueline kennedy onassis high school,2011,709,447,262,37,159,20,491
20K506,new school #2 @ k314                            ,2012,813,389,424,179,7,30,593
06M326,ms 326  writers today & leaders tomorrow,2011,360,140,220,1,49,5,305
10X310,p.s. 310 marble hill,2017,791,385,406,7,76,32,670
09X236,p.s. 236 langston hughes,2017,312,162,150,4,85,4,216
11X545,bronx aerospace academy,2008,377,73,304,7,132,3,232
14K126,jhs 126 john ericsson,2010,420,193,227,12,82,20,306
22K254,ps 254 dag hammarskjold,2011,623,310,313,221,37,301,61
