total_enrollment,female_num,male_num,asian_num,black_num,white_num,hispanic_num
396,178,218,120,14,179,74
707,441,266,39,172,21,473
499,261,238,37,189,32,223
742,350,392,26,145,15,544
3758,2053,1705,1099,1427,841,385
430,213,217,9,78,106,204
426,298,128,1,156,1,266
3608,1590,2018,1270,340,664,1326
610,289,321,14,112,65,419
420,211,209,1,166,8,242
420,305,115,16,102,193,75
756,192,564,34,534,16,154
454,218,236,12,229,6,200
317,317,0,9,265,4,36
123,60,63,2,70,5,43
505,255,250,97,301,15,85
291,77,214,9,93,13,156
414,277,137,26,51,27,301
805,417,388,5,198,14,579
579,296,283,6,531,5,30
814,402,412,482,17,56,258
413,233,180,25,42,29,315
223,110,113,14,16,6,185
272,117,155,0,73,4,191
2661,1242,1419,614,550,140,1302
1341,657,684,24,198,82,1031
170,57,113,19,48,9,94
418,259,159,27,81,86,222
464,207,257,1,389,5,65
335,207,128,24,166,3,140
641,335,306,129,87,213,209
601,270,331,35,431,6,94
348,176,172,9,313,7,18
502,236,266,53,139,181,120
886,450,436,8,28,4,846
575,278,297,33,95,133,314
815,392,423,177,156,56,422
353,120,233,7,216,17,108
922,472,450,14,793,26,78
1393,685,708,659,35,559,131
393,194,199,27,81,10,270
891,430,461,295,14,342,240
1220,595,625,33,210,15,944
251,124,127,2,220,2,20
187,93,94,3,159,3,22
139,68,71,13,26,68,29
208,134,74,0,76,2,129
795,374,421,17,27,711,39
154,74,80,3,39,4,107
490,323,167,48,122,31,280
97,47,50,7,31,16,42
383,185,198,10,214,8,137
192,58,134,2,85,7,97
434,113,321,82,128,68,128
434,259,175,29,156,0,245
637,284,353,19,284,38,286
459,217,242,15,16,412,11
294,167,127,3,231,2,57
314,205,109,8,117,1,185
575,85,490,1,164,6,398
438,227,211,2,84,3,347
275,113,162,6,148,15,98
498,319,179,90,41,305,49
572,294,278,11,51,12,496
275,150,125,9,69,5,186
246,112,134,5,96,3,137
534,386,148,17,219,35,228
324,156,168,2,272,4,45
633,307,326,39,391,38,145
435,228,207,1,119,2,303
493,266,227,212,10,51,217
283,127,156,14,56,121,91
4120,1834,2286,255,922,576,2234
1093,762,331,524,86,354,129
396,198,198,3,316,11,64
573,281,292,224,48,14,287
409,188,221,31,318,7,47
549,288,261,223,48,200,71
979,462,517,31,445,76,415
413,197,216,2,79,6,322
192,97,95,2,172,1,15
747,365,382,137,20,33,542
1493,713,780,98,396,319,666
292,149,143,13,6,125,127
752,369,383,23,78,24,623
537,255,282,7,151,6,372
598,271,327,58,143,62,331
897,421,476,640,20,154,67
1032,584,448,5,996,2,29
615,316,299,69,41,362,110
821,393,428,15,23,26,757
471,191,280,8,46,4,413
385,199,186,5,128,4,243
792,164,628,41,212,154,368
547,357,190,7,394,4,131
426,218,208,2,171,4,242
301,154,147,69,55,3,168
650,323,327,155,123,68,303
489,240,249,13,108,137,222
533,275,258,12,15,89,413
3037,1297,1740,1891,91,702,195
598,305,293,13,521,2,57
359,243,116,11,281,4,52
712,355,357,16,643,21,29
522,264,258,273,43,91,113
103,54,49,15,12,17,55
379,180,199,16,25,4,283
449,251,198,40,30,270,101
446,232,214,94,63,158,120
203,117,86,1,70,9,121
697,287,410,28,237,94,329
1051,495,556,371,109,178,349
796,406,390,19,165,8,593
559,266,293,12,62,9,475
397,133,264,9,201,60,113
396,276,120,3,335,3,53
1276,603,673,348,312,383,231
191,99,92,2,87,0,102
362,178,184,2,113,5,241
771,341,430,64,139,302,231
4159,2033,2126,278,1282,86,2478
373,187,186,33,132,16,183
664,336,328,199,24,102,338
351,154,197,6,227,4,113
482,238,244,9,79,14,372
421,206,215,5,308,7,90
220,71,149,6,196,0,15
221,113,108,34,34,35,112
341,165,176,39,13,20,266
559,559,0,2,183,2,364
128,77,51,1,15,1,74
637,396,241,180,59,237,158
484,224,260,10,145,4,320
1127,540,587,13,857,4,250
1244,611,633,138,298,267,526
605,313,292,8,401,4,190
4021,2346,1675,1077,921,1144,816
526,274,252,2,267,2,253
384,97,287,17,96,19,250
382,382,0,5,102,2,263
930,490,440,38,67,4,806
408,187,221,1,153,15,239
219,104,115,2,111,3,101
648,301,347,12,147,13,468
1095,547,548,562,131,239,161
570,282,288,9,159,5,396
1136,636,499,186,86,579,232
374,166,208,14,304,7,43
269,131,138,0,236,2,28
203,104,99,7,160,20,13
769,375,394,28,6,664,59
959,468,491,59,107,11,755
1200,540,660,88,270,66,764
436,213,223,33,141,12,236
537,266,271,145,15,275,49
827,409,418,1,206,11,608
544,256,288,4,243,6,288
2039,1015,1024,156,48,20,1812
218,119,99,2,64,2,144
396,200,196,21,82,9,280
389,209,180,1,309,3,68
152,72,80,46,14,66,24
464,230,234,2,79,19,353
273,139,134,44,8,111,110
274,0,274,0,194,3,68
254,128,126,33,29,89,85
258,132,126,2,180,4,71
395,127,268,6,219,29,137
591,301,290,5,184,13,388
450,231,219,10,90,7,340
398,152,246,3,344,4,39
942,480,462,63,79,458,288
271,134,137,10,86,97,67
341,184,157,94,47,46,153
139,71,68,4,116,5,13
905,444,461,126,491,136,129
1007,447,560,97,237,283,384
566,373,193,4,480,7,74
552,260,292,9,293,18,225
704,386,318,348,221,27,65
481,228,253,19,192,70,198
1133,564,569,87,603,16,410
528,269,259,5,67,1,454
273,147,126,11,107,43,95
817,370,447,57,38,579,140
201,99,102,3,116,7,71
894,422,472,5,544,11,333
748,380,368,34,28,591,91
907,425,482,156,22,377,346
974,472,502,257,90,277,346
1196,608,588,211,16,382,515
211,72,139,10,56,48,95
732,367,365,116,80,20,502
244,125,119,1,159,40,34
447,203,244,15,387,7,34
547,253,294,298,98,25,116
842,427,415,63,577,40,155
976,463,513,31,6,885,48
590,318,272,7,200,4,376
426,243,183,3,121,6,296
699,396,303,33,237,21,392
915,431,484,129,42,559,164
1267,587,680,156,82,74,952
133,65,68,7,3,22,100
356,188,168,56,15,233,51
152,74,78,54,2,16,80
520,296,224,59,46,287,104
828,441,387,0,732,3,89
356,175,181,187,56,16,86
271,145,126,3,41,1,226
357,196,161,8,279,2,68
693,347,346,73,196,37,385
631,287,344,2,177,5,444
101,54,47,0,75,2,21
639,311,328,20,163,147,307
415,204,211,8,119,6,281
321,148,173,3,97,116,94
459,231,228,5,430,7,17
494,224,270,15,415,11,34
405,206,199,17,15,271,99
224,128,96,1,3,0,220
367,156,211,4,142,29,192
373,196,177,10,23,2,335
391,202,189,5,105,19,251
522,248,274,122,34,158,199
983,469,514,292,8,98,579
373,187,186,246,19,43,64
221,125,96,0,189,3,22
344,168,176,5,90,0,247
703,345,358,6,46,11,638
260,139,121,14,147,7,92
796,414,382,439,9,203,134
591,306,285,49,136,266,130
645,314,331,278,17,274,75
3885,2282,1603,1001,880,1084,815
1184,550,634,858,89,22,208
201,95,106,7,150,16,24
131,67,64,2,33,1,95
295,153,142,4,12,32,243
989,427,562,619,101,40,220
1619,766,853,288,298,619,407
764,331,433,187,229,42,297
535,256,279,86,64,312,71
333,81,252,2,239,3,79
1413,707,706,101,16,589,680
227,115,112,5,99,40,59
728,380,348,40,269,126,288
352,155,197,9,235,2,100
710,353,357,9,78,6,612
99,41,58,1,38,1,58
425,236,189,3,123,9,276
1664,335,1329,77,1124,18,407
3800,1988,1812,970,348,1197,1220
468,239,229,66,45,35,312
457,238,219,1,192,2,253
988,497,491,41,7,816,113
515,237,278,3,458,4,45
810,378,432,2,648,6,147
163,71,92,4,56,9,94
138,77,61,4,53,35,40
664,327,337,31,7,584,42
748,346,402,199,18,341,184
181,87,94,1,146,4,28
122,63,59,8,33,1,77
903,445,458,294,10,339,257
746,310,436,7,161,2,569
233,136,97,9,78,15,129
561,280,281,3,501,5,48
316,145,171,5,246,4,54
636,268,368,22,157,8,442
1208,586,622,108,15,58,1021
358,156,202,1,94,5,257
131,73,58,3,110,3,13
596,292,304,4,216,7,361
241,136,105,1,178,0,56
362,253,109,10,300,5,35
548,270,278,2,203,3,339
788,393,395,589,6,33,157
1018,523,495,76,256,103,555
232,107,125,4,54,0,171
207,94,113,18,87,20,78
430,204,226,61,11,248,53
650,343,307,2,234,18,394
687,326,361,16,91,18,559
237,112,125,0,94,7,136
492,239,253,1,215,4,270
676,355,321,16,137,21,495
381,200,181,62,91,25,197
414,201,213,4,139,13,235
226,113,113,12,106,27,67
149,76,73,0,91,2,54
736,346,390,24,120,10,574
625,303,322,4,469,2,143
696,342,354,15,629,14,37
892,448,444,14,791,14,71
1737,828,909,187,11,12,1503
1255,619,636,593,75,478,109
1140,558,582,34,5,1007,88
326,148,178,2,114,2,207
573,358,215,157,75,194,137
192,0,192,15,98,15,60
449,242,207,4,108,6,321
428,227,201,1,342,1,82
430,190,240,16,208,10,175
532,268,264,22,282,29,180
889,429,460,417,14,265,189
722,355,367,1,678,5,34
1752,876,876,70,236,29,1416
574,268,306,4,314,5,243
633,288,345,56,348,15,181
475,221,254,20,372,3,75
416,184,232,2,380,11,20
1158,569,589,570,12,261,309
419,186,233,2,86,3,325
598,294,304,14,529,14,35
981,445,536,131,18,423,402
512,265,247,3,206,2,298
562,284,278,234,25,194,62
66,36,30,2,57,1,2
452,224,228,90,105,129,104
145,84,61,4,49,42,42
1160,600,560,36,986,33,94
411,186,225,2,18,7,381
573,269,304,475,32,41,22
326,148,178,1,125,0,199
1462,744,718,225,230,474,530
512,257,255,14,34,11,441
167,72,95,16,24,20,106
1913,904,1009,961,152,85,691
1160,579,581,216,6,645,278
216,100,116,1,0,0,215
1632,808,824,100,98,585,834
328,175,153,12,117,10,187
1335,643,692,157,168,23,982
563,287,276,7,85,10,459
312,156,156,4,244,4,57
524,255,269,361,17,38,104
285,167,118,22,132,18,107
647,328,319,6,587,13,38
548,349,199,150,50,165,122
1021,483,538,386,320,37,191
714,325,389,0,133,3,578
494,237,257,69,26,50,319
693,331,362,475,52,37,129
315,168,147,15,181,2,104
523,278,245,8,232,4,272
368,185,183,0,360,2,3
105,56,49,1,87,1,12
444,216,228,8,406,5,23
417,201,216,7,355,2,43
2437,1111,1326,650,150,374,1226
651,307,344,3,194,7,435
687,348,339,79,157,141,290
246,135,111,0,50,6,188
1026,480,546,28,533,27,426
354,124,230,9,276,13,48
269,128,141,22,208,11,28
467,342,125,28,133,198,87
318,162,156,14,217,4,69
542,235,307,14,91,6,427
74,31,43,1,68,2,3
529,262,267,36,414,2,75
805,418,387,42,590,28,142
614,395,219,1,528,6,74
626,308,318,10,535,28,52
298,150,148,1,201,0,91
777,420,357,3,700,19,51
244,113,131,1,179,2,58
404,319,85,6,347,2,49
62,23,39,5,21,4,32
1314,650,664,402,17,624,267
773,413,360,14,528,17,211
433,205,228,30,224,101,77
533,417,116,17,175,15,313
608,246,362,5,543,6,36
1115,565,550,9,47,8,1051
396,188,208,18,106,35,224
853,373,480,64,685,5,89
557,284,273,30,144,49,329
499,257,242,33,3,8,451
1385,666,719,417,84,534,293
661,329,332,29,532,19,68
468,228,240,14,119,56,276
812,384,428,12,514,7,274
970,471,499,44,6,779,133
1125,544,581,586,145,240,152
856,402,454,34,222,18,578
521,256,265,8,419,38,53
289,173,116,18,208,1,61
481,269,212,13,107,5,354
293,147,146,2,56,1,230
222,130,92,3,100,11,107
1235,529,706,446,14,701,67
199,117,82,2,58,4,134
572,270,302,51,14,6,499
408,272,136,2,158,2,242
488,246,242,2,253,3,224
679,312,367,288,76,193,115
1299,705,594,15,1238,9,33
377,185,192,3,342,3,24
2168,417,1751,668,135,237,1067
466,258,208,11,124,5,325
683,345,338,10,469,10,178
408,198,210,68,98,11,227
896,446,450,47,9,455,375
919,425,494,461,9,190,257
828,413,415,153,518,54,96
335,173,162,13,73,12,235
924,433,491,665,19,140,79
580,330,250,29,328,36,181
574,294,280,20,138,8,405
490,230,260,10,55,15,410
349,205,144,3,52,3,276
485,243,242,37,13,39,394
538,273,265,7,8,456,63
373,266,107,7,319,2,33
242,134,108,6,177,4,48
720,361,359,15,587,8,100
143,92,51,1,122,1,16
249,135,114,0,191,1,55
360,192,168,3,155,2,196
170,78,92,3,136,0,26
534,258,276,10,478,8,38
490,241,249,21,11,3,440
933,463,470,67,66,471,270
643,366,277,206,67,162,207
579,272,307,4,431,3,135
440,232,208,6,174,6,251
248,120,128,3,206,1,34
137,71,66,2,54,1,61
801,385,416,225,66,215,290
374,168,206,0,296,4,73
566,237,329,3,511,6,32
1753,1126,627,23,615,10,1089
332,160,172,12,83,8,227
823,342,481,8,237,13,551
131,78,53,5,49,40,32
563,272,291,2,455,12,91
506,242,264,239,8,8,251
571,273,298,21,416,4,110
2558,1377,1181,164,938,416,1001
250,137,113,5,189,10,44
943,465,478,331,77,195,333
911,412,499,270,9,56,570
713,365,348,217,27,291,173
807,378,429,176,510,5,110
566,323,243,54,147,175,154
1210,571,639,569,18,219,387
1178,509,669,349,573,10,244
445,219,226,3,126,2,312
2587,1437,1150,166,934,387,1051
359,122,237,9,94,5,251
348,211,137,2,113,8,224
523,258,265,10,257,17,231
589,295,294,13,102,24,441
834,398,436,607,8,102,116
471,222,249,1,23,9,437
401,200,201,6,115,4,274
521,273,248,1,196,7,315
419,231,188,7,389,1,20
503,168,335,1,176,19,304
726,357,369,3,240,2,465
1025,551,474,124,171,618,85
265,119,146,33,18,97,108
806,385,421,1,485,6,312
432,200,232,206,12,151,62
504,253,251,10,137,3,352
295,132,163,3,203,8,79
238,110,128,1,226,0,8
373,147,226,19,302,11,35
82,33,49,1,40,1,37
486,235,251,15,316,11,141
244,126,118,5,90,31,99
876,463,413,30,588,98,99
932,436,496,199,123,428,161
759,361,398,150,45,419,144
979,529,450,8,868,16,80
362,122,240,10,284,10,50
465,239,226,61,73,68,247
542,271,271,54,110,288,71
442,216,226,6,112,4,315
267,129,138,3,228,0,32
495,278,217,95,228,22,144
393,255,138,26,110,20,233
376,188,188,20,47,13,292
303,152,151,10,252,3,31
429,68,361,22,133,4,270
425,172,253,4,152,3,260
252,110,142,2,222,1,26
1368,684,684,122,171,169,874
1026,470,556,66,192,5,753
421,195,226,9,133,2,273
889,461,428,6,832,4,42
969,519,450,3,328,13,620
138,72,66,0,116,1,19
536,248,288,7,74,5,447
1637,828,809,99,97,635,799
674,316,358,23,193,11,437
678,352,326,29,459,4,179
551,253,298,294,20,187,49
388,177,211,10,104,19,255
275,122,153,1,92,7,172
196,36,160,7,71,8,110
367,207,160,23,127,29,173
607,327,280,49,185,40,329
171,83,88,5,6,2,157
355,174,181,6,253,1,95
372,21,351,10,195,9,152
753,376,377,2,458,9,273
403,98,305,101,72,58,165
382,195,187,7,355,2,17
397,197,200,17,294,11,66
338,153,185,1,275,1,61
1028,497,531,20,250,19,718
2542,1170,1372,577,1506,61,380
362,161,201,105,7,171,79
292,146,146,44,54,10,182
458,212,246,1,200,1,256
1689,805,884,147,69,29,1428
2411,1346,1065,74,791,46,1449
207,94,113,1,189,3,9
502,235,267,11,115,6,363
516,231,285,29,162,78,237
1016,489,527,359,98,163,352
616,279,337,80,211,64,248
386,232,154,41,211,16,117
193,110,83,11,54,5,121
716,373,343,37,504,4,37
1123,566,557,2,7,15,1096
458,206,252,1,210,2,244
1544,685,859,433,765,53,209
545,266,279,123,29,299,93
190,99,91,20,52,6,110
259,130,129,12,145,6,95
701,354,347,158,106,9,427
658,324,334,7,170,4,472
787,378,409,6,198,41,534
1661,801,860,852,23,72,711
200,107,93,2,171,2,21
222,117,105,21,9,105,81
727,384,343,139,109,245,233
1029,520,509,396,16,216,396
833,356,477,191,35,480,118
506,262,244,93,39,320,51
3986,2189,1797,1399,1165,889,491
669,316,353,5,9,601,51
1145,585,560,5,339,12,783
479,259,220,0,219,2,257
668,292,376,1,616,5,36
335,175,160,4,83,1,246
236,122,114,106,13,72,21
388,182,206,0,106,6,275
202,92,110,0,56,19,125
239,120,119,5,177,5,52
3813,1916,1897,208,74,3137,378
478,252,226,181,6,57,234
224,101,123,23,119,6,71
676,370,306,27,143,24,475
246,78,168,5,89,7,144
360,158,202,8,294,10,45
138,21,117,3,41,0,93
265,121,144,2,226,1,33
885,428,457,471,5,245,154
290,174,116,6,63,9,207
679,336,343,2,602,4,68
4235,2155,2080,1966,570,817,874
760,374,386,20,137,12,581
543,255,288,201,12,203,122
4538,2006,2532,1281,235,1441,1464
110,47,63,0,0,0,110
915,517,398,63,481,24,341
256,170,86,28,31,134,58
379,218,161,4,299,1,70
1666,796,870,100,31,6,1528
512,153,359,8,190,150,158
368,193,175,30,22,172,137
311,161,150,6,224,3,74
251,114,137,4,46,0,201
451,237,214,7,364,14,55
555,136,419,7,227,16,250
798,381,417,3,747,7,38
1038,498,540,102,244,259,414
1499,1056,443,24,1351,13,88
528,345,183,7,134,10,375
239,86,153,13,50,80,94
571,297,274,32,33,430,63
197,86,111,7,116,5,68
397,397,0,17,323,8,45
313,105,208,5,270,10,24
134,56,78,4,63,0,67
690,386,304,7,554,13,102
208,100,108,80,49,11,48
198,102,96,0,151,3,44
157,93,64,8,53,32,60
603,282,321,1,18,3,581
473,239,234,3,153,1,307
304,171,133,5,85,5,207
313,248,65,4,148,2,153
154,81,73,0,36,0,118
70,24,46,0,18,13,37
456,238,218,0,148,1,300
243,112,131,17,53,17,150
470,238,232,6,397,0,53
461,226,235,6,203,2,244
376,186,190,12,285,9,65
852,470,382,28,595,16,209
601,297,304,5,458,10,128
971,475,496,84,210,7,669
402,188,214,13,120,1,263
271,145,126,8,158,4,95
247,98,149,9,199,4,21
415,207,208,0,4,0,411
544,255,289,5,235,8,296
959,299,660,339,104,118,341
662,318,344,283,111,101,150
980,500,480,688,8,97,163
193,101,92,0,17,3,172
494,259,235,8,150,132,191
483,257,226,61,17,276,122
410,219,191,6,383,11,7
552,261,291,434,29,5,82
553,282,271,12,298,19,218
420,229,191,115,171,18,93
1617,817,800,230,251,464,669
1099,505,594,228,25,394,445
362,173,189,0,84,7,267
646,318,328,6,341,27,269
1291,629,662,40,235,15,975
551,285,266,7,142,6,393
1865,896,969,163,28,26,1639
206,100,106,5,136,3,60
364,193,169,12,281,11,39
375,171,204,5,190,11,164
598,291,307,65,284,13,229
370,193,177,25,16,204,122
443,212,231,21,273,28,121
532,273,259,5,485,8,27
189,90,99,1,145,1,42
1002,472,530,431,12,356,195
605,300,305,9,201,8,385
147,66,81,5,128,3,11
601,307,294,20,534,3,43
354,163,191,5,223,2,115
183,81,102,48,62,20,45
350,172,178,74,43,60,166
518,235,283,4,192,5,314
661,338,323,4,322,5,322
959,483,476,355,25,381,129
520,231,289,6,201,10,301
402,217,185,3,168,6,185
584,319,265,4,170,6,401
766,384,382,28,7,665,57
415,196,219,275,60,41,39
389,180,209,6,334,2,32
826,421,405,613,86,42,76
967,467,500,16,296,4,631
539,262,277,5,464,10,55
793,370,423,66,27,561,79
525,253,272,4,127,3,387
583,285,298,28,9,260,263
370,212,158,11,19,9,330
719,357,362,1,664,13,38
417,230,187,48,37,63,253
445,195,250,10,141,15,278
215,102,113,3,171,4,36
858,439,419,255,7,55,541
503,226,277,215,12,199,73
210,55,155,7,74,8,120
87,42,45,0,78,1,8
1925,943,982,155,27,29,1709
493,114,379,78,168,124,113
263,49,214,3,145,21,92
256,130,126,4,232,4,13
265,142,123,2,118,13,129
377,182,195,16,218,60,68
190,94,96,11,12,102,63
1470,722,748,408,723,27,290
441,229,212,9,128,94,193
692,340,352,20,319,120,226
403,196,207,2,220,13,166
953,467,486,4,21,9,915
890,421,469,34,11,755,79
1518,738,780,160,70,57,1227
397,134,263,60,248,10,59
1625,807,816,312,299,80,884
332,186,146,16,106,7,194
660,318,342,44,127,114,369
343,179,164,4,71,1,267
371,139,232,41,141,18,158
353,134,219,5,308,2,34
554,328,226,119,22,344,47
465,236,229,69,76,53,257
394,186,208,17,24,27,323
444,209,235,20,126,9,276
151,81,70,1,134,1,14
319,218,101,4,211,4,69
453,220,233,3,369,0,79
460,304,156,21,347,5,79
1257,627,630,623,9,50,559
387,194,193,140,18,48,160
151,67,84,3,127,2,17
574,292,282,7,463,46,49
521,258,263,122,23,250,121
687,364,323,5,208,3,463
367,175,192,1,0,0,366
131,70,61,1,70,1,58
714,330,384,3,228,3,478
655,345,310,444,12,138,56
974,479,495,659,10,106,177
944,464,480,23,599,16,302
962,473,489,849,10,32,46
729,362,367,84,7,512,55
707,353,354,198,60,264,163
122,63,59,0,100,1,19
511,225,286,0,23,3,485
540,265,275,175,52,27,264
518,251,267,10,123,3,372
391,189,202,13,102,17,252
432,230,202,4,207,3,215
2885,1270,1615,48,2401,60,331
645,305,340,96,39,384,68
991,481,510,57,12,454,449
564,284,280,8,491,4,54
241,116,125,4,112,5,115
1162,564,598,494,12,152,499
219,105,114,1,24,0,187
409,209,200,31,39,5,333
663,320,343,11,397,39,213
409,204,205,14,82,7,303
599,269,330,15,120,14,446
151,72,79,1,37,3,110
757,367,390,162,134,13,448
453,214,239,15,177,174,55
626,333,293,4,574,16,29
463,221,242,2,394,10,56
508,236,272,27,434,10,36
450,264,186,19,193,29,180
1172,593,579,36,1002,37,84
267,121,146,2,65,2,194
211,69,142,6,102,11,89
232,107,125,16,48,10,153
162,76,86,23,115,3,17
1051,567,484,223,129,608,88
721,341,380,20,11,542,137
898,445,453,256,76,292,271
517,265,252,5,341,3,154
390,195,195,13,47,83,245
368,161,207,5,152,13,193
855,422,433,100,183,202,343
242,121,121,108,34,37,62
795,372,423,91,281,103,314
415,164,251,11,179,11,208
242,133,109,25,5,130,78
528,250,278,7,486,6,26
464,208,256,4,416,14,25
788,406,382,11,538,5,231
723,344,379,51,8,8,650
1141,801,340,662,59,231,123
1157,582,575,85,160,92,808
324,77,247,4,233,5,79
865,420,445,178,133,393,144
541,255,286,6,258,24,247
1721,868,853,166,150,549,844
544,255,289,35,14,436,56
364,110,254,22,307,5,19
147,90,57,3,52,43,41
737,396,341,112,17,73,535
515,248,267,3,272,2,226
206,99,107,3,108,0,94
203,107,96,3,98,3,96
659,341,318,35,433,24,151
1462,719,743,178,204,16,1058
460,260,200,20,195,22,188
368,194,174,45,59,9,253
952,481,471,254,8,378,292
185,68,117,22,49,6,106
325,157,168,0,78,2,245
347,347,0,7,101,3,228
482,482,0,43,115,20,292
460,220,240,50,106,15,283
476,228,248,118,176,26,119
498,239,259,0,0,0,497
337,17,320,12,165,10,143
793,368,425,125,5,556,107
503,249,254,93,137,31,232
920,458,462,52,2,744,107
258,134,124,34,30,102,81
1007,470,537,326,10,565,101
423,199,224,14,109,8,287
423,202,221,144,19,168,86
930,464,466,134,211,21,546
883,416,467,164,192,53,472
435,162,273,42,168,24,185
488,213,275,110,128,18,232
235,119,116,0,216,1,14
388,182,206,4,62,3,319
83,46,37,7,39,3,30
298,160,138,120,36,93,48
723,358,365,80,43,458,132
1197,562,635,92,271,37,788
901,407,494,184,22,333,353
469,239,230,12,288,14,143
199,108,91,2,186,1,8
586,286,300,11,9,11,551
980,498,482,63,622,27,260
319,157,162,3,116,1,199
514,238,276,2,288,2,217
484,218,266,19,126,29,295
262,123,139,14,44,123,73
1642,851,791,232,199,435,761
594,363,231,17,218,7,335
611,278,333,59,337,14,176
491,233,258,104,38,43,303
554,361,193,17,202,9,319
566,349,217,6,396,5,146
1104,545,559,601,4,39,444
339,136,203,8,254,2,64
841,443,398,0,651,6,170
462,225,237,2,427,8,22
1082,523,559,28,617,23,399
489,112,377,89,150,130,111
503,258,245,9,269,10,210
269,107,162,15,127,11,109
294,154,140,1,88,1,198
320,162,158,2,74,1,241
212,0,212,0,189,3,20
1676,905,771,66,529,29,1035
823,464,359,79,75,31,634
1114,582,532,1,3,5,1105
729,357,372,20,233,8,458
362,182,180,113,67,50,131
656,304,352,31,187,14,412
604,412,192,76,28,387,69
924,459,465,56,129,565,106
1181,575,606,665,10,267,238
1471,708,763,49,16,1229,154
298,125,173,3,229,2,61
343,164,179,21,88,36,194
482,195,287,13,182,8,276
530,292,238,154,13,64,295
646,304,342,116,121,43,362
1063,572,491,238,103,551,163
336,159,177,2,257,1,74
491,218,273,10,307,29,134
548,270,278,14,16,80,435
398,398,0,6,136,5,246
192,92,100,4,155,2,25
17,10,7,0,12,1,4
898,430,468,34,6,792,63
370,237,133,4,133,2,228
165,79,86,0,0,0,165
451,264,187,10,168,5,262
783,380,403,131,45,434,168
754,389,365,18,495,7,226
620,299,321,34,136,80,366
502,247,255,93,40,283,83
343,187,156,43,4,26,260
620,322,298,5,550,3,55
241,121,120,4,53,2,177
198,44,154,9,44,97,45
250,123,127,0,178,0,68
311,143,168,0,258,2,48
309,146,163,3,100,0,206
208,45,163,10,45,98,50
323,154,169,44,78,35,161
1056,496,560,351,28,79,598
433,223,210,9,167,3,249
3060,1275,1785,670,276,150,1940
649,312,337,345,7,159,136
263,150,113,15,151,8,88
1012,501,511,392,274,60,260
436,202,234,10,107,18,292
3828,1758,2070,616,1026,1618,563
564,232,332,175,235,6,146
372,173,199,12,112,14,229
743,358,385,175,72,23,453
419,204,215,3,3,0,412
338,184,154,6,105,5,218
427,116,311,27,133,13,253
773,359,414,182,14,325,236
443,207,236,28,252,27,133
408,224,184,56,38,32,270
441,321,120,12,360,1,60
505,253,252,0,239,4,259
240,132,108,4,198,1,37
417,68,349,28,143,6,233
431,212,219,46,313,10,41
992,525,467,305,22,209,450
284,170,114,7,214,4,55
307,152,155,13,84,8,197
497,259,238,4,289,6,184
663,326,337,8,565,27,63
549,248,301,34,394,13,96
747,366,381,686,19,3,37
322,83,239,95,114,22,66
728,355,373,37,182,28,474
691,427,264,35,179,27,439
322,166,156,129,88,9,46
5,2,3,0,0,0,5
600,345,255,6,480,8,101
918,442,476,4,189,11,709
251,130,121,3,73,1,171
495,401,94,20,163,78,202
810,374,436,553,78,27,146
152,63,89,10,109,3,30
661,336,325,51,534,7,62
538,267,271,17,14,84,419
1044,516,528,41,535,38,427
271,127,144,24,51,15,180
998,491,507,43,266,102,582
635,323,312,35,413,31,144
812,401,411,55,21,511,200
747,370,377,25,7,660,48
843,436,407,29,506,13,295
824,388,436,18,29,732,44
471,248,223,2,125,5,338
366,184,182,6,264,27,60
95,38,57,4,22,12,54
1372,680,692,17,437,12,901
757,388,369,71,16,518,72
396,188,208,1,2,3,390
529,244,285,4,119,10,394
984,481,503,353,6,512,112
268,56,212,11,91,26,134
520,261,259,2,292,5,210
577,301,276,6,81,2,487
657,345,312,12,153,11,474
435,194,241,15,211,5,193
602,271,331,3,504,2,90
708,313,395,1,141,15,547
1825,908,917,799,32,44,946
528,185,343,12,184,26,301
2808,1223,1585,1723,114,750,211
184,87,97,29,10,101,25
1698,832,866,119,65,468,1029
578,311,267,22,395,2,155
1995,998,997,426,2,35,1518
209,89,120,9,137,5,57
223,102,121,1,142,4,57
433,185,248,8,127,12,286
575,281,294,256,22,194,62
507,254,253,13,31,13,450
573,307,266,13,92,2,462
608,0,608,1,364,2,231
1099,525,574,44,707,24,315
812,435,377,3,764,4,37
320,149,171,10,104,6,197
153,81,72,5,64,21,59
1176,478,698,6,1043,8,103
1447,717,730,77,424,36,872
1523,729,794,822,64,183,444
436,221,215,8,315,21,91
453,222,231,5,171,4,267
914,447,467,10,278,2,614
511,245,266,2,43,7,457
309,138,171,6,117,5,177
396,202,194,61,38,211,83
297,135,162,2,181,10,102
82,38,44,5,32,9,35
437,231,206,124,83,46,171
599,285,314,23,33,143,392
1483,755,728,238,223,482,539
330,158,172,143,18,109,54
338,193,145,1,123,6,199
318,153,165,3,69,6,237
804,382,422,161,534,6,95
981,529,452,12,311,11,641
461,222,239,8,157,3,283
741,345,396,66,328,100,242
299,167,132,8,243,4,42
783,406,377,110,235,19,311
187,105,82,1,157,1,28
644,294,350,139,156,174,170
693,331,362,20,350,78,238
259,128,131,3,100,2,152
1792,1252,540,358,303,145,950
324,148,176,85,129,35,71
1166,621,545,108,269,26,758
704,317,387,173,124,61,339
881,413,468,42,244,515,76
403,195,208,8,60,13,321
785,357,428,7,730,7,18
1246,616,630,28,823,28,344
342,157,185,4,183,2,152
448,195,253,9,5,386,46
148,73,75,1,126,1,9
584,286,298,24,151,4,404
410,225,185,35,119,6,244
488,255,233,6,191,2,279
283,143,140,5,63,7,205
373,183,190,3,147,0,222
451,105,346,28,324,16,79
709,447,262,37,159,20,491
813,389,424,179,7,30,593
360,140,220,1,49,5,305
791,385,406,7,76,32,670
312,162,150,4,85,4,216
377,73,304,7,132,3,232
420,193,227,12,82,20,306
623,310,313,221,37,301,61
